lowRate,cheapestRate_allNights_baseFare,cheapestRate_allNights_fees,cheapestRate_allNights_taxes,cheapestRate_allNights_totalFare,cheapestRate_perNight_baseFare,cheapestRate_perNight_fees,cheapestRate_perNight_taxes,cheapestRate_perNight_totalFare,originalRate_allNights_baseFare,originalRate_allNights_fees,originalRate_allNights_taxes,originalRate_allNights_totalFare,originalRate_perNight_baseFare,originalRate_perNight_fees,originalRate_perNight_taxes,originalRate_perNight_totalFare
7175300,5930000,0,1245300,7175300,1976666,0.0,415100.0,2391767,6300000,0,1323000,7623000,2100000,0.0,441000.0,2541000
7202361,5952365,0,1249996,7202361,1984121,0.0,416665.33,2400787,6196051,0,1301171,7497222,2065350,0.0,433723.67,2499074
3884100,3210000,674100,0,3884100,1070000,224700.0,0.0,1294700,4280000,898800,0,5178800,1426666,299600.0,0.0,1726267
23490093,19413300,0,4076793,23490093,6471100,0.0,1358931.0,7830031,25884400,0,5435724,31320124,8628133,0.0,1811908.0,10440041
16334999,13499999,0,2835000,16334999,4499999,0.0,945000.0,5445000,17999999,0,3780000,21779999,5999999,0.0,1260000.0,7260000
3943390,3259000,0,684390,3943390,1086333,0.0,228130.0,1314463,4345333,0,912520,5257853,1448444,0.0,304173.33,1752618
4650000,3842975,0,807025,4650000,1280991,0.0,269008.33,1550000,5123967,0,1076033,6200000,1707989,0.0,358677.67,2066667
10975680,9572120,0,1403560,10975680,3190706,0.0,467853.33,3658560,12762827,0,1871413,14634240,4254275,0.0,623804.33,4878080
13380180,11058000,2322180,0,13380180,3686000,774060.0,0.0,4460060,14744000,3096240,0,17840240,4914666,1032080.0,0.0,5946747
10945000,9045455,1899545,0,10945000,3015151,633181.67,0.0,3648333,12060607,2532727,0,14593334,4020202,844242.33,0.0,4864445
7716002,6376861,0,1339141,7716002,2125620,0.0,446380.33,2572001,8502481,0,1785522,10288003,2834160,0.0,595174.0,3429334
8075000,6673554,0,1401446,8075000,2224518,0.0,467148.67,2691667,7231406,0,1518594,8750000,2410468,0.0,506198.0,2916667
3316000,2740495,0,575505,3316000,913498,0.0,191835.0,1105333,3653993,0,767340,4421333,1217997,0.0,255780.0,1473778
3018000,2494215,0,523785,3018000,831405,0.0,174595.0,1006000,3325620,0,698380,4024000,1108540,0.0,232793.33,1341333
24502500,20250000,4252500,0,24502500,6750000,1417500.0,0.0,8167500,27000000,5670000,0,32670000,9000000,1890000.0,0.0,10890000
28132500,23250000,0,4882500,28132500,7750000,0.0,1627500.0,9377500,31000000,0,6510000,37510000,10333333,0.0,2170000.0,12503333
6480000,5355372,0,1124628,6480000,1785124,0.0,374876.0,2160000,7140496,0,1499504,8640000,2380165,0.0,499834.67,2880000
3400000,2809917,0,590083,3400000,936639,0.0,196694.33,1133333,3746556,0,786777,4533333,1248852,0.0,262259.0,1511111
4389000,3627273,0,761727,4389000,1209091,0.0,253909.0,1463000,4836364,0,1015636,5852000,1612121,0.0,338545.33,1950667
9027057,7460377,0,1566680,9027057,2486792,0.0,522226.67,3009019,13150655,0,0,13150655,4383551,0.0,0.0,4383552
9958300,8230000,1728300,0,9958300,2743333,576100.0,0.0,3319433,10973333,2304400,0,13277733,3657777,768133.33,0.0,4425911
3431560,2836000,0,595560,3431560,945333,0.0,198520.0,1143853,3781333,0,794080,4575413,1260444,0.0,264693.33,1525138
5820000,4809917,0,1010083,5820000,1603305,0.0,336694.33,1940000,8016530,0,1683470,9700000,2672176,0.0,561156.67,3233333
3050000,2520662,0,529338,3050000,840220,0.0,176446.0,1016667,3360883,0,705784,4066667,1120294,0.0,235261.33,1355556
9234378,7631718,0,1602660,9234378,2543906,0.0,534220.0,3078126,8479685,0,1780735,10260420,2826561,0.0,593578.33,3420140
10326140,8534000,1792140,0,10326140,2844666,597380.0,0.0,3442047,11378667,2389520,0,13768187,3792889,796506.67,0.0,4589396
8165000,6747934,0,1417066,8165000,2249311,0.0,472355.33,2721667,8997245,0,1889422,10886667,2999081,0.0,629807.33,3628889
2930000,2421487,0,508513,2930000,807162,0.0,169504.33,976667,3228649,0,678018,3906667,1076216,0.0,226006.0,1302222
16372221,13956986,1150134,1265101,16372221,4652328,383378.0,421700.33,5457407,18609367,1533564,1686748,21829679,6203122,511188.0,562249.33,7276560
3670000,3033057,0,636943,3670000,1011019,0.0,212314.33,1223333,4044076,0,849257,4893333,1348025,0.0,283085.67,1631111
7260000,6000000,1260000,0,7260000,2000000,420000.0,0.0,2420000,8000000,1680000,0,9680000,2666666,560000.0,0.0,3226667
6777833,5601515,0,1176318,6777833,1867171,0.0,392106.0,2259278,6015515,0,1263258,7278773,2005171,0.0,421086.0,2426258
4270000,3528925,0,741075,4270000,1176308,0.0,247025.0,1423333,4705233,0,988100,5693333,1568411,0.0,329366.67,1897778
3165336,2698108,222571,244657,3165336,899369,74190.33,81552.33,1055112,3597478,296814,326260,4220552,1199159,98938.0,108753.33,1406851
3950000,3264463,0,685537,3950000,1088154,0.0,228512.33,1316667,4352617,0,914050,5266667,1450872,0.0,304683.33,1755556
19420500,16050000,3370500,0,19420500,5350000,1123500.0,0.0,6473500,21400000,4494000,0,25894000,7133333,1498000.0,0.0,8631333
3640354,3008557,0,631797,3640354,1002852,0.0,210599.0,1213451,3166902,0,665050,3831952,1055634,0.0,221683.33,1277317
2573438,2126808,0,446630,2573438,708936,0.0,148876.67,857813,2417356,0,507644,2925000,805785,0.0,169214.67,975000
2904000,2400000,0,504000,2904000,800000,0.0,168000.0,968000,3200000,0,672000,3872000,1066666,0.0,224000.0,1290667
3204840,2648629,0,556211,3204840,882876,0.0,185403.67,1068280,3531505,0,741615,4273120,1177168,0.0,247205.0,1424373
2525000,2086777,0,438223,2525000,695592,0.0,146074.33,841667,2272727,0,477273,2750000,757575,0.0,159091.0,916667
4704539,4010511,330489,363539,4704539,1336837,110163.0,121179.67,1568180,5347348,440600,484770,6272718,1782449,146866.67,161590.0,2090906
2142424,1770600,371824,0,2142424,590200,123941.33,0.0,714141,2360800,495765,0,2856565,786933,165255.0,0.0,952188
1741500,1439256,0,302244,1741500,479752,0.0,100748.0,580500,1919008,0,402992,2322000,639669,0.0,134330.67,774000
4406700,3641900,0,764800,4406700,1213966,0.0,254933.33,1468900,3748760,0,787240,4536000,1249586,0.0,262413.33,1512000
5360000,4429753,0,930247,5360000,1476584,0.0,310082.33,1786667,5906337,0,1240330,7146667,1968779,0.0,413443.33,2382222
3033000,2506611,0,526389,3033000,835537,0.0,175463.0,1011000,3342148,0,701852,4044000,1114049,0.0,233950.67,1348000
9958300,8230000,1728300,0,9958300,2743333,576100.0,0.0,3319433,10973333,2304400,0,13277733,3657777,768133.33,0.0,4425911
2735000,2260331,0,474669,2735000,753443,0.0,158223.0,911667,3013775,0,632892,3646667,1004591,0.0,210964.0,1215556
4748040,3924000,824040,0,4748040,1308000,274680.0,0.0,1582680,5232000,1098720,0,6330720,1744000,366240.0,0.0,2110240
9970400,8240000,1730400,0,9970400,2746666,576800.0,0.0,3323467,10986667,2307200,0,13293867,3662222,769066.67,0.0,4431289
5353380,4424280,0,929100,5353380,1474760,0.0,309700.0,1784460,5899040,0,1238800,7137840,1966346,0.0,412933.33,2379280
2735003,2260333,0,474670,2735003,753444,0.0,158223.33,911668,3013777,0,632894,3646671,1004592,0.0,210964.67,1215557
1750000,1446281,0,303719,1750000,482093,0.0,101239.67,583333,1928375,0,404958,2333333,642791,0.0,134986.0,777778
3480000,2876034,0,603966,3480000,958678,0.0,201322.0,1160000,3834712,0,805288,4640000,1278237,0.0,268429.33,1546667
4875000,4028925,0,846075,4875000,1342975,0.0,282025.0,1625000,5371900,0,1128100,6500000,1790633,0.0,376033.33,2166667
15960534,13190520,2770014,0,15960534,4396840,923338.0,0.0,5320178,17587360,3693352,0,21280712,5862453,1231117.33,0.0,7093571
4208542,3478134,730408,0,4208542,1159378,243469.33,0.0,1402847,4637512,973877,0,5611389,1545837,324625.67,0.0,1870463
3950000,3264463,0,685537,3950000,1088154,0.0,228512.33,1316667,4352617,0,914050,5266667,1450872,0.0,304683.33,1755556
5254446,4342518,0,911928,5254446,1447506,0.0,303976.0,1751482,5790024,0,1215904,7005928,1930008,0.0,405301.33,2335309
6679200,5520000,1159200,0,6679200,1840000,386400.0,0.0,2226400,7360000,1545600,0,8905600,2453333,515200.0,0.0,2968533
6059556,5007897,0,1051659,6059556,1669299,0.0,350553.0,2019852,5434344,0,1141212,6575556,1811448,0.0,380404.0,2191852
9195999,7599999,1596000,0,9195999,2533333,532000.0,0.0,3065333,10133332,2128000,0,12261332,3377777,709333.33,0.0,4087111
15540985,13248235,1091711,1201039,15540985,4416078,363903.67,400346.33,5180328,17664262,1455563,1601385,20721210,5888087,485187.67,533795.0,6907070
6405900,5294132,0,1111768,6405900,1764710,0.0,370589.33,2135300,7058843,0,1482357,8541200,2352947,0.0,494119.0,2847067
4235002,3500000,735002,0,4235002,1166666,245000.67,0.0,1411667,4666667,980003,0,5646670,1555555,326667.67,0.0,1882223
2780000,2297521,0,482479,2780000,765840,0.0,160826.33,926667,3063361,0,643305,3706666,1021120,0.0,214435.0,1235555
2200000,1818181,0,381819,2200000,606060,0.0,127273.0,733333,2424241,0,509092,2933333,808080,0.0,169697.33,977778
4677598,3987643,328610,361345,4677598,1329214,109536.67,120448.33,1559199,5316805,438094,481794,6236693,1772268,146031.33,160598.0,2078898
9950000,8223141,0,1726859,9950000,2741047,0.0,575619.67,3316667,10000000,0,2100000,12100000,3333333,0.0,700000.0,4033333
7178688,5932800,0,1245888,7178688,1977600,0.0,415296.0,2392896,7910400,0,1661184,9571584,2636800,0.0,553728.0,3190528
1839000,1519835,0,319165,1839000,506611,0.0,106388.33,613000,2026447,0,425553,2452000,675482,0.0,141851.0,817333
8563883,7077589,0,1486294,8563883,2359196,0.0,495431.33,2854628,7298589,0,1532704,8831293,2432863,0.0,510901.33,2943764
5265000,4351239,0,913761,5265000,1450413,0.0,304587.0,1755000,5801652,0,1218348,7020000,1933884,0.0,406116.0,2340000
7739130,6395976,0,1343154,7739130,2131992,0.0,447718.0,2579710,8527968,0,1790872,10318840,2842656,0.0,596957.33,3439613
6679200,5520000,1159200,0,6679200,1840000,386400.0,0.0,2226400,7360000,1545600,0,8905600,2453333,515200.0,0.0,2968533
1644000,1358677,0,285323,1644000,452892,0.0,95107.67,548000,1811569,0,380431,2192000,603856,0.0,126810.33,730667
8833000,7300000,1533000,0,8833000,2433333,511000.0,0.0,2944333,9733333,2044000,0,11777333,3244444,681333.33,0.0,3925778
7055554,5831037,0,1224517,7055554,1943679,0.0,408172.33,2351851,8330052,0,1749311,10079363,2776684,0.0,583103.67,3359788
5750000,4752066,0,997934,5750000,1584022,0.0,332644.67,1916667,6336088,0,1330579,7666667,2112029,0.0,443526.33,2555556
3170000,2619834,0,550166,3170000,873278,0.0,183388.67,1056667,3493112,0,733555,4226667,1164370,0.0,244518.33,1408889
5278500,4362396,0,916104,5278500,1454132,0.0,305368.0,1759500,5132231,0,1077769,6210000,1710743,0.0,359256.33,2070000
11210000,9264463,0,1945537,11210000,3088154,0.0,648512.33,3736667,12352617,0,2594050,14946667,4117539,0.0,864683.33,4982222
3557500,2940082,0,617418,3557500,980027,0.0,205806.0,1185833,3057851,0,642149,3700000,1019283,0.0,214049.67,1233333
3656000,3021487,0,634513,3656000,1007162,0.0,211504.33,1218667,4028649,0,846018,4874667,1342883,0.0,282006.0,1624889
3452002,2852893,599109,0,3452002,950964,199703.0,0.0,1150667,3803857,798812,0,4602669,1267952,266270.67,0.0,1534223
2020000,1669422,0,350578,2020000,556474,0.0,116859.33,673333,2225896,0,467437,2693333,741965,0.0,155812.33,897778
3052500,2522728,0,529772,3052500,840909,0.0,176590.67,1017500,3657026,0,767974,4425000,1219008,0.0,255991.33,1475000
3288999,2718181,570818,0,3288999,906060,190272.67,0.0,1096333,3624241,761091,0,4385332,1208080,253697.0,0.0,1461777
7005900,5790000,1215900,0,7005900,1930000,405300.0,0.0,2335300,7720000,1621200,0,9341200,2573333,540400.0,0.0,3113733
2990000,2471074,0,518926,2990000,823691,0.0,172975.33,996667,3294765,0,691902,3986667,1098255,0.0,230634.0,1328889
6612904,5465210,0,1147694,6612904,1821736,0.0,382564.67,2204301,7286947,0,1530258,8817205,2428982,0.0,510086.0,2939068
3100500,2562397,0,538103,3100500,854132,0.0,179367.67,1033500,3416529,0,717471,4134000,1138843,0.0,239157.0,1378000
1776000,1467769,0,308231,1776000,489256,0.0,102743.67,592000,1957025,0,410975,2368000,652341,0.0,136991.67,789333
4964000,4102480,0,861520,4964000,1367493,0.0,287173.33,1654667,5469973,0,1148694,6618667,1823324,0.0,382898.0,2206222
2769957,2289221,0,480736,2769957,763073,0.0,160245.33,923319,3052295,0,640981,3693276,1017431,0.0,213660.33,1231092
4909999,4057851,0,852148,4909999,1352617,0.0,284049.33,1636666,5410468,0,1136197,6546665,1803489,0.0,378732.33,2182222
10200000,8429752,0,1770248,10200000,2809917,0.0,590082.67,3400000,11239669,0,2360331,13600000,3746556,0.0,786777.0,4533333
2726500,2253306,0,473194,2726500,751102,0.0,157731.33,908833,3004408,0,630925,3635333,1001469,0.0,210308.33,1211778
2540000,2099174,0,440826,2540000,699724,0.0,146942.0,846667,2305785,0,484215,2790000,768595,0.0,161405.0,930000
6000000,4958677,0,1041323,6000000,1652892,0.0,347107.67,2000000,6611569,0,1388431,8000000,2203856,0.0,462810.33,2666667
8606315,7112658,0,1493657,8606315,2370886,0.0,497885.67,2868772,9483544,0,1991543,11475087,3161181,0.0,663847.67,3825029
2584666,2136088,0,448578,2584666,712029,0.0,149526.0,861555,2848117,0,598104,3446221,949372,0.0,199368.0,1148740
1720000,1421487,0,298513,1720000,473829,0.0,99504.33,573333,1895316,0,398017,2293333,631772,0.0,132672.33,764444
3111829,2571759,0,540070,3111829,857253,0.0,180023.33,1037276,3429012,0,720093,4149105,1143004,0.0,240031.0,1383035
4444443,3673093,0,771350,4444443,1224364,0.0,257116.67,1481481,4897457,0,1028467,5925924,1632485,0.0,342822.33,1975308
6111112,5050506,0,1060606,6111112,1683502,0.0,353535.33,2037037,6734008,0,1414141,8148149,2244669,0.0,471380.33,2716050
6500000,5371901,0,1128099,6500000,1790633,0.0,376033.0,2166667,7162535,0,1504132,8666667,2387511,0.0,501377.33,2888889
7107543,5874000,1233543,0,7107543,1958000,411181.0,0.0,2369181,7832000,1644724,0,9476724,2610666,548241.33,0.0,3158908
1836622,1517870,0,318752,1836622,505956,0.0,106250.67,612207,2023827,0,425002,2448829,674609,0.0,141667.33,816276
900000,743802,156198,0,900000,247934,52066.0,0.0,300000,991736,208264,0,1200000,330578,69421.33,0.0,400000
3615199,2987767,627432,0,3615199,995922,209144.0,0.0,1205066,3209915,627432,0,3837347,1069971,209144.0,0.0,1279116
1130000,933885,0,196115,1130000,311295,0.0,65371.67,376667,1245180,0,261487,1506667,415060,0.0,87162.33,502222
1438200,1188596,0,249604,1438200,396198,0.0,83201.33,479400,1264464,0,265536,1530000,421488,0.0,88512.0,510000
2020003,1669422,350581,0,2020003,556474,116860.33,0.0,673334,2225896,467441,0,2693337,741965,155813.67,0.0,897779
443571,366587,0,76984,443571,122195,0.0,25661.33,147857,469985,0,98696,568681,156661,0.0,32898.67,189560
1990000,1644629,0,345371,1990000,548209,0.0,115123.67,663333,2192839,0,460494,2653333,730946,0.0,153498.0,884444
825000,681819,0,143181,825000,227273,0.0,47727.0,275000,909092,0,190908,1100000,303030,0.0,63636.0,366667
1166000,963636,0,202364,1166000,321212,0.0,67454.67,388667,1284848,0,269819,1554667,428282,0.0,89939.67,518222
1950000,1611570,0,338430,1950000,537190,0.0,112810.0,650000,2148760,0,451240,2600000,716253,0.0,150413.33,866667
1290000,1066115,0,223885,1290000,355371,0.0,74628.33,430000,1421487,0,298513,1720000,473829,0.0,99504.33,573333
1104886,913128,0,191758,1104886,304376,0.0,63919.33,368295,980714,0,205950,1186664,326904,0.0,68650.0,395555
1648320,1362247,0,286073,1648320,454082,0.0,95357.67,549440,1477685,0,310315,1788000,492561,0.0,103438.33,596000
1351913,1117284,0,234629,1351913,372428,0.0,78209.67,450638,1294726,0,271893,1566619,431575,0.0,90631.0,522206
840000,694214,0,145786,840000,231404,0.0,48595.33,280000,867768,0,182232,1050000,289256,0.0,60744.0,350000
930000,768594,0,161406,930000,256198,0.0,53802.0,310000,1024792,0,215208,1240000,341597,0.0,71736.0,413333
1080000,892563,0,187437,1080000,297521,0.0,62479.0,360000,1190084,0,249916,1440000,396694,0.0,83305.33,480000
599997,495864,0,104133,599997,165288,0.0,34711.0,199999,661152,0,138844,799996,220384,0.0,46281.33,266665
266380,220148,0,46232,266380,73382,0.0,15410.67,88793,323749,0,67987,391736,107916,0.0,22662.33,130579
646797,534543,0,112254,646797,178181,0.0,37418.0,215599,712724,0,149672,862396,237574,0.0,49890.67,287465
652618,539354,0,113264,652618,179784,0.0,37754.67,217539,856118,0,179785,1035903,285372,0.0,59928.33,345301
780705,645210,0,135495,780705,215070,0.0,45165.0,260235,816723,0,171513,988236,272241,0.0,57171.0,329412
812250,671280,0,140970,812250,223760,0.0,46990.0,270750,706611,0,148389,855000,235537,0.0,49463.0,285000
515033,425647,0,89386,515033,141882,0.0,29795.33,171678,625951,0,131450,757401,208650,0.0,43816.67,252467
486579,402131,0,84448,486579,134043,0.0,28149.33,162193,515553,0,108266,623819,171851,0.0,36088.67,207940
1448000,1196695,0,251305,1448000,398898,0.0,83768.33,482667,1595593,0,335074,1930667,531864,0.0,111691.33,643556
1166000,963636,0,202364,1166000,321212,0.0,67454.67,388667,1284848,0,269819,1554667,428282,0.0,89939.67,518222
420651,347646,0,73005,420651,115882,0.0,24335.0,140217,445698,0,93598,539296,148566,0.0,31199.33,179765
900000,743802,156198,0,900000,247934,52066.0,0.0,300000,991736,208264,0,1200000,330578,69421.33,0.0,400000
659459,545008,0,114451,659459,181669,0.0,38150.33,219820,698727,0,146733,845460,232909,0.0,48911.0,281820
960000,793388,0,166612,960000,264462,0.0,55537.33,320000,1057851,0,222149,1280000,352617,0.0,74049.67,426667
431285,356434,0,74851,431285,118811,0.0,24950.33,143762,456967,0,95963,552930,152322,0.0,31987.67,184310
2374274,1962210,0,412064,2374274,654070,0.0,137354.67,791425,2687958,0,564472,3252430,895986,0.0,188157.33,1084143
1194000,986778,0,207222,1194000,328926,0.0,69074.0,398000,1315704,0,276296,1592000,438568,0.0,92098.67,530667
209997,173550,0,36447,209997,57850,0.0,12149.0,69999,231400,0,48596,279996,77133,0.0,16198.67,93332
423423,349936,0,73487,423423,116645,0.0,24495.67,141141,448635,0,94214,542849,149545,0.0,31404.67,180950
773916,639599,0,134317,773916,213199,0.0,44772.33,257972,872181,0,183159,1055340,290727,0.0,61053.0,351780
404772,334523,0,70249,404772,111507,0.0,23416.33,134924,428874,0,90064,518938,142958,0.0,30021.33,172979
1365150,1128222,0,236928,1365150,376074,0.0,78976.0,455050,1187604,0,249396,1437000,395868,0.0,83132.0,479000
3144000,2598347,0,545653,3144000,866115,0.0,181884.33,1048000,3464463,0,727537,4192000,1154821,0.0,242512.33,1397333
1555000,1285124,0,269876,1555000,428374,0.0,89958.67,518333,1713499,0,359834,2073333,571166,0.0,119944.67,691111
2845000,2351239,0,493761,2845000,783746,0.0,164587.0,948333,3134985,0,658348,3793333,1044995,0.0,219449.33,1264444
2744313,2268027,0,476286,2744313,756009,0.0,158762.0,914771,3024036,0,635048,3659084,1008012,0.0,211682.67,1219695
1140000,942149,0,197851,1140000,314049,0.0,65950.33,380000,1256199,0,263801,1520000,418733,0.0,87933.67,506667
2543000,2101653,0,441347,2543000,700551,0.0,147115.67,847667,2802204,0,588463,3390667,934068,0.0,196154.33,1130222
850000,702480,0,147520,850000,234160,0.0,49173.33,283333,936640,0,196693,1133333,312213,0.0,65564.33,377778
399249,329957,0,69292,399249,109985,0.0,23097.33,133083,523742,0,109985,633727,174580,0.0,36661.67,211242
2625000,2169420,0,455580,2625000,723140,0.0,151860.0,875000,3099174,0,650826,3750000,1033058,0.0,216942.0,1250000
1100000,909091,0,190909,1100000,303030,0.0,63636.33,366667,1212121,0,254546,1466667,404040,0.0,84848.67,488889
697360,576330,0,121030,697360,192110,0.0,40343.33,232453,738886,0,155165,894051,246295,0.0,51721.67,298017
1320000,1090908,0,229092,1320000,363636,0.0,76364.0,440000,1454544,0,305456,1760000,484848,0.0,101818.67,586667
1770000,1462809,0,307191,1770000,487603,0.0,102397.0,590000,1950412,0,409588,2360000,650137,0.0,136529.33,786667
2085365,1723443,0,361922,2085365,574481,0.0,120640.67,695122,2297924,0,482563,2780487,765974,0.0,160854.33,926829
1716870,1418901,0,297969,1716870,472967,0.0,99323.0,572290,1891868,0,397292,2289160,630622,0.0,132430.67,763053
1058826,875064,0,183762,1058826,291688,0.0,61254.0,352942,1166752,0,245016,1411768,388917,0.0,81672.0,470589
900000,743802,0,156198,900000,247934,0.0,52066.0,300000,991736,0,208264,1200000,330578,0.0,69421.33,400000
1620000,1338843,0,281157,1620000,446281,0.0,93719.0,540000,1785124,0,374876,2160000,595041,0.0,124958.67,720000
1350000,1115703,0,234297,1350000,371901,0.0,78099.0,450000,1487604,0,312396,1800000,495868,0.0,104132.0,600000
773557,639303,0,134254,773557,213101,0.0,44751.33,257852,1014767,0,213101,1227868,338255,0.0,71033.67,409289
399249,329957,0,69292,399249,109985,0.0,23097.33,133083,523742,0,109985,633727,174580,0.0,36661.67,211242
839997,694212,0,145785,839997,231404,0.0,48595.0,279999,925616,0,194380,1119996,308538,0.0,64793.33,373332
1342258,1109304,0,232954,1342258,369768,0.0,77651.33,447419,1422184,0,298659,1720843,474061,0.0,99553.0,573614
1090250,901034,0,189216,1090250,300344,0.0,63072.0,363417,1201379,0,252288,1453667,400459,0.0,84096.0,484556
2040000,1685949,0,354051,2040000,561983,0.0,118017.0,680000,2247932,0,472068,2720000,749310,0.0,157356.0,906667
3031101,2505042,0,526059,3031101,835014,0.0,175353.0,1010367,3340056,0,701412,4041468,1113352,0.0,233804.0,1347156
3224000,2664463,0,559537,3224000,888154,0.0,186512.33,1074667,3552617,0,746050,4298667,1184205,0.0,248683.33,1432889
4767576,3940146,0,827430,4767576,1313382,0.0,275810.0,1589192,5253528,0,1103240,6356768,1751176,0.0,367746.67,2118923
3059182,2528249,530933,0,3059182,842749,176977.67,0.0,1019727,2906033,530933,0,3436966,968677,176977.67,0.0,1145655
3932500,3250000,682500,0,3932500,1083333,227500.0,0.0,1310833,4333333,910000,0,5243333,1444444,303333.33,0.0,1747778
3601002,2976035,0,624967,3601002,992011,0.0,208322.33,1200334,3968047,0,833289,4801336,1322682,0.0,277763.0,1600445
5520000,4561983,0,958017,5520000,1520661,0.0,319339.0,1840000,6082644,0,1277356,7360000,2027548,0.0,425785.33,2453333
3059182,2528249,530933,0,3059182,842749,176977.67,0.0,1019727,2906033,530933,0,3436966,968677,176977.67,0.0,1145655
2924000,2416530,0,507470,2924000,805510,0.0,169156.67,974667,2842975,0,597025,3440000,947658,0.0,199008.33,1146667
2834888,2342883,0,492005,2834888,780961,0.0,164001.67,944963,3123844,0,656007,3779851,1041281,0.0,218669.0,1259950
2924000,2416530,0,507470,2924000,805510,0.0,169156.67,974667,2842975,0,597025,3440000,947658,0.0,199008.33,1146667
4491400,3711900,0,779500,4491400,1237300,0.0,259833.33,1497133,4949200,0,1039333,5988533,1649733,0.0,346444.33,1996178
1800000,1487603,0,312397,1800000,495867,0.0,104132.33,600000,1983471,0,416529,2400000,661157,0.0,138843.0,800000
1326000,1095868,0,230132,1326000,365289,0.0,76710.67,442000,1461157,0,306843,1768000,487052,0.0,102281.0,589333
1050000,867768,0,182232,1050000,289256,0.0,60744.0,350000,1157024,0,242976,1400000,385674,0.0,80992.0,466667
2150000,1776860,0,373140,2150000,592286,0.0,124380.0,716667,2369147,0,497520,2866667,789715,0.0,165840.0,955556
977705,808021,0,169684,977705,269340,0.0,56561.33,325902,1035924,0,217543,1253467,345308,0.0,72514.33,417822
1500000,1239669,0,260331,1500000,413223,0.0,86777.0,500000,1652892,0,347108,2000000,550964,0.0,115702.67,666667
1392500,1150827,0,241673,1392500,383609,0.0,80557.67,464167,1534436,0,322231,1856667,511478,0.0,107410.33,618889
2121266,1753113,0,368153,2121266,584371,0.0,122717.67,707089,2337484,0,490871,2828355,779161,0.0,163623.67,942785
270000,223140,0,46860,270000,74380,0.0,15620.0,90000,297520,0,62480,360000,99173,0.0,20826.67,120000
502524,415309,0,87215,502524,138436,0.0,29071.67,167508,532447,0,111814,644261,177482,0.0,37271.33,214754
1860508,1537610,0,322898,1860508,512536,0.0,107632.67,620169,1971295,0,413972,2385267,657098,0.0,137990.67,795089
970000,801653,0,168347,970000,267217,0.0,56115.67,323333,1068871,0,224462,1293333,356290,0.0,74820.67,431111
1650000,1363635,0,286365,1650000,454545,0.0,95455.0,550000,1818180,0,381820,2200000,606060,0.0,127273.33,733333
1050000,867768,0,182232,1050000,289256,0.0,60744.0,350000,1157024,0,242976,1400000,385674,0.0,80992.0,466667
667000,551239,0,115761,667000,183746,0.0,38587.0,222333,734985,0,154348,889333,244995,0.0,51449.33,296444
736000,608265,0,127735,736000,202755,0.0,42578.33,245333,811020,0,170313,981333,270340,0.0,56771.0,327111
1500000,1239669,0,260331,1500000,413223,0.0,86777.0,500000,1652892,0,347108,2000000,550964,0.0,115702.67,666667
1350000,1115703,0,234297,1350000,371901,0.0,78099.0,450000,1487604,0,312396,1800000,495868,0.0,104132.0,600000
1019408,834896,0,184512,1019408,278298,0.0,61504.0,339803,1391493,0,307520,1699013,463831,0.0,102506.67,566338
854698,699998,0,154700,854698,233332,0.0,51566.67,284899,1166666,0,257832,1424498,388888,0.0,85944.0,474833
509997,421485,0,88512,509997,140495,0.0,29504.0,169999,561980,0,118016,679996,187326,0.0,39338.67,226665
6010974,4967747,0,1043227,6010974,1655915,0.0,347742.33,2003658,5183450,0,1088524,6271974,1727816,0.0,362841.33,2090658
3449045,2850451,0,598594,3449045,950150,0.0,199531.33,1149682,3800601,0,798126,4598727,1266867,0.0,266042.0,1532909
4355553,3599631,0,755922,4355553,1199877,0.0,251974.0,1451851,4799508,0,1007896,5807404,1599836,0.0,335965.33,1935801
4155400,3434215,0,721185,4155400,1144738,0.0,240395.0,1385133,4578953,0,961580,5540533,1526317,0.0,320526.67,1846844
2242000,1852892,0,389108,2242000,617630,0.0,129702.67,747333,2470523,0,518810,2989333,823507,0.0,172936.67,996444
1552634,1283169,0,269465,1552634,427723,0.0,89821.67,517545,1710892,0,359287,2070179,570297,0.0,119762.33,690060
14111110,11662074,0,2449036,14111110,3887358,0.0,816345.33,4703703,14577593,0,3061295,17638888,4859197,0.0,1020431.67,5879629
1602000,1323967,0,278033,1602000,441322,0.0,92677.67,534000,1765289,0,370711,2136000,588429,0.0,123570.33,712000
2590000,2140496,0,449504,2590000,713498,0.0,149834.67,863333,2853995,0,599338,3453333,951331,0.0,199779.33,1151111
2411200,1992728,0,418472,2411200,664242,0.0,139490.67,803733,2656971,0,557962,3214933,885657,0.0,185987.33,1071644
3884486,3210320,0,674166,3884486,1070106,0.0,224722.0,1294829,4280427,0,898888,5179315,1426809,0.0,299629.33,1726438
3300000,2727272,0,572728,3300000,909090,0.0,190909.33,1100000,3636363,0,763637,4400000,1212121,0.0,254545.67,1466667
4100000,3388429,0,711571,4100000,1129476,0.0,237190.33,1366667,4517905,0,948762,5466667,1505968,0.0,316254.0,1822222
1651110,1364553,0,286557,1651110,454851,0.0,95519.0,550370,1819404,0,382076,2201480,606468,0.0,127358.67,733827
3169000,2619008,0,549992,3169000,873002,0.0,183330.67,1056333,3492011,0,733322,4225333,1164003,0.0,244440.67,1408444
1670809,1380832,289977,0,1670809,460277,96659.0,0.0,556936,1545202,289977,0,1835179,515067,96659.0,0.0,611726
2750000,2272727,0,477273,2750000,757575,0.0,159091.0,916667,3030303,0,636364,3666667,1010101,0.0,212121.33,1222222
2400000,1983471,0,416529,2400000,661157,0.0,138843.0,800000,2644628,0,555372,3200000,881542,0.0,185124.0,1066667
1835000,1516530,0,318470,1835000,505510,0.0,106156.67,611667,2022040,0,424627,2446667,674013,0.0,141542.33,815556
1238000,1023140,0,214860,1238000,341046,0.0,71620.0,412667,1364187,0,286480,1650667,454729,0.0,95493.33,550222
1370000,1132232,0,237768,1370000,377410,0.0,79256.0,456667,1509643,0,317024,1826667,503214,0.0,105674.67,608889
1799000,1486777,0,312223,1799000,495592,0.0,104074.33,599667,1982369,0,416298,2398667,660789,0.0,138766.0,799556
1602000,1323967,0,278033,1602000,441322,0.0,92677.67,534000,1765289,0,370711,2136000,588429,0.0,123570.33,712000
1195000,987603,0,207397,1195000,329201,0.0,69132.33,398333,1316804,0,276529,1593333,438934,0.0,92176.33,531111
1125000,929751,0,195249,1125000,309917,0.0,65083.0,375000,1239668,0,260332,1500000,413222,0.0,86777.33,500000
430263,355589,0,74674,430263,118529,0.0,24891.33,143421,455884,0,95736,551620,151961,0.0,31912.0,183873
1110000,917355,0,192645,1110000,305785,0.0,64215.0,370000,1223140,0,256860,1480000,407713,0.0,85620.0,493333
928800,767603,0,161197,928800,255867,0.0,53732.33,309600,959504,0,201496,1161000,319834,0.0,67165.33,387000
947619,776100,0,171519,947619,258700,0.0,57173.0,315873,1583877,0,350037,1933914,527959,0.0,116679.0,644638
869700,718761,0,150939,869700,239587,0.0,50313.0,289900,958348,0,201252,1159600,319449,0.0,67084.0,386533
923338,763089,0,160249,923338,254363,0.0,53416.33,307779,1271814,0,267082,1538896,423938,0.0,89027.33,512965
915000,756198,0,158802,915000,252066,0.0,52934.0,305000,1008264,0,211736,1220000,336088,0.0,70578.67,406667
975000,805786,0,169214,975000,268595,0.0,56404.67,325000,1074381,0,225619,1300000,358127,0.0,75206.33,433333
498701,412150,0,86551,498701,137383,0.0,28850.33,166234,606102,0,127281,733383,202034,0.0,42427.0,244461
920000,760331,0,159669,920000,253443,0.0,53223.0,306667,1013775,0,212892,1226667,337925,0.0,70964.0,408889
540000,446280,0,93720,540000,148760,0.0,31240.0,180000,595040,0,124960,720000,198346,0.0,41653.33,240000
448951,371034,0,77917,448951,123678,0.0,25972.33,149650,588942,0,123678,712620,196314,0.0,41226.0,237540
298845,246980,0,51865,298845,82326,0.0,17288.33,99615,392031,0,82326,474357,130677,0.0,27442.0,158119
910000,752066,0,157934,910000,250688,0.0,52644.67,303333,1002755,0,210578,1213333,334251,0.0,70192.67,404444
435000,359505,0,75495,435000,119835,0.0,25165.0,145000,479340,0,100660,580000,159780,0.0,33553.33,193333
716098,591816,0,124282,716098,197272,0.0,41427.33,238699,870318,0,182768,1053086,290106,0.0,60922.67,351029
1650000,1363635,0,286365,1650000,454545,0.0,95455.0,550000,1818180,0,381820,2200000,606060,0.0,127273.33,733333
491620,406298,0,85322,491620,135432,0.0,28440.67,163873,644917,0,135432,780349,214972,0.0,45144.0,260116
370049,305826,0,64223,370049,101942,0.0,21407.67,123350,485437,0,101942,587379,161812,0.0,33980.67,195793
317554,262442,0,55112,317554,87480,0.0,18370.67,105851,336463,0,70657,407120,112154,0.0,23552.33,135707
915000,756198,0,158802,915000,252066,0.0,52934.0,305000,1008264,0,211736,1220000,336088,0.0,70578.67,406667
1485000,1227273,257727,0,1485000,409091,85909.0,0.0,495000,1363636,257727,0,1621363,454545,85909.0,0.0,540454
397215,328277,0,68938,397215,109425,0.0,22979.33,132405,420868,0,88383,509251,140289,0.0,29461.0,169750
405000,334710,0,70290,405000,111570,0.0,23430.0,135000,446280,0,93720,540000,148760,0.0,31240.0,180000
174821,144480,0,30341,174821,48160,0.0,10113.67,58274,185230,0,38898,224128,61743,0.0,12966.0,74709
454026,375228,0,78798,454026,125076,0.0,26266.0,151342,481063,0,101022,582085,160354,0.0,33674.0,194028
3134000,2590083,0,543917,3134000,863361,0.0,181305.67,1044667,3453444,0,725223,4178667,1151148,0.0,241741.0,1392889
9107345,7526731,0,1580614,9107345,2508910,0.0,526871.33,3035782,10035641,0,2107486,12143127,3345213,0.0,702495.33,4047709
4648000,3841322,0,806678,4648000,1280440,0.0,268892.67,1549333,5121763,0,1075570,6197333,1707254,0.0,358523.33,2065778
7133333,5895316,0,1238017,7133333,1965105,0.0,412672.33,2377778,7860421,0,1650690,9511111,2620140,0.0,550230.0,3170370
3342999,2762809,0,580190,3342999,920936,0.0,193396.67,1114333,3683745,0,773587,4457332,1227915,0.0,257862.33,1485777
8675297,7169667,0,1505630,8675297,2389889,0.0,501876.67,2891766,9559556,0,2007507,11567063,3186518,0.0,669169.0,3855688
7505300,6202727,0,1302573,7505300,2067575,0.0,434191.0,2501767,8270303,0,1736764,10007067,2756767,0.0,578921.33,3335689
2794000,2309091,0,484909,2794000,769697,0.0,161636.33,931333,4198347,0,881653,5080000,1399449,0.0,293884.33,1693333
2950000,2438016,0,511984,2950000,812672,0.0,170661.33,983333,3250688,0,682645,3933333,1083562,0.0,227548.33,1311111
2794000,2309091,0,484909,2794000,769697,0.0,161636.33,931333,4198347,0,881653,5080000,1399449,0.0,293884.33,1693333
2470000,2041322,0,428678,2470000,680440,0.0,142892.67,823333,2721763,0,571570,3293333,907254,0.0,190523.33,1097778
3250000,2685951,0,564049,3250000,895317,0.0,188016.33,1083333,3581268,0,752065,4333333,1193756,0.0,250688.33,1444444
2730000,2256198,0,473802,2730000,752066,0.0,157934.0,910000,3008264,0,631736,3640000,1002754,0.0,210578.67,1213333
4000000,3305785,0,694215,4000000,1101928,0.0,231405.0,1333333,4407713,0,925620,5333333,1469237,0.0,308540.0,1777778
2235000,1847108,0,387892,2235000,615702,0.0,129297.33,745000,2462811,0,517189,2980000,820937,0.0,172396.33,993333
2600000,2148761,0,451239,2600000,716253,0.0,150413.0,866667,2865015,0,601652,3466667,955005,0.0,200550.67,1155556
2167000,1790909,0,376091,2167000,596969,0.0,125363.67,722333,2387879,0,501454,2889333,795959,0.0,167151.33,963111
2750000,2272727,0,477273,2750000,757575,0.0,159091.0,916667,3030303,0,636364,3666667,1010101,0.0,212121.33,1222222
1870984,1546268,0,324716,1870984,515422,0.0,108238.67,623661,2061691,0,432954,2494645,687230,0.0,144318.0,831548
13260000,10958677,0,2301323,13260000,3652892,0.0,767107.67,4420000,14611569,0,3068431,17680000,4870523,0.0,1022810.33,5893333
1600000,1322314,0,277686,1600000,440771,0.0,92562.0,533333,1763085,0,370248,2133333,587695,0.0,123416.0,711111
1764000,1457850,0,306150,1764000,485950,0.0,102050.0,588000,1943800,0,408200,2352000,647933,0.0,136066.67,784000
3210000,2652893,0,557107,3210000,884297,0.0,185702.33,1070000,3537191,0,742809,4280000,1179063,0.0,247603.0,1426667
2378000,1965289,0,412711,2378000,655096,0.0,137570.33,792667,2620385,0,550282,3170667,873461,0.0,183427.33,1056889
710000,586776,0,123224,710000,195592,0.0,41074.67,236667,1173554,0,246446,1420000,391184,0.0,82148.67,473333
75888000,62717356,0,13170644,75888000,20905785,0.0,4390214.67,25296000,83623141,0,17560859,101184000,27874380,0.0,5853619.67,33728000
7300000,6033058,0,1266942,7300000,2011019,0.0,422314.0,2433333,8044077,0,1689256,9733333,2681359,0.0,563085.33,3244444
2125000,1756198,0,368802,2125000,585399,0.0,122934.0,708333,2066116,0,433884,2500000,688705,0.0,144628.0,833333
6545000,5409091,0,1135909,6545000,1803030,0.0,378636.33,2181667,7212121,0,1514546,8726667,2404040,0.0,504848.67,2908889
2820000,2330579,0,489421,2820000,776859,0.0,163140.33,940000,3107439,0,652561,3760000,1035813,0.0,217520.33,1253333
8100000,6694215,0,1405785,8100000,2231405,0.0,468595.0,2700000,8925620,0,1874380,10800000,2975206,0.0,624793.33,3600000
3371197,2786113,0,585084,3371197,928704,0.0,195028.0,1123732,2827293,0,593731,3421024,942431,0.0,197910.33,1140341
3312900,2737934,0,574966,3312900,912644,0.0,191655.33,1104300,3650579,0,766621,4417200,1216859,0.0,255540.33,1472400
4197000,3468596,0,728404,4197000,1156198,0.0,242801.33,1399000,4624795,0,971205,5596000,1541598,0.0,323735.0,1865333
4197000,3468596,0,728404,4197000,1156198,0.0,242801.33,1399000,4624795,0,971205,5596000,1541598,0.0,323735.0,1865333
2125000,1756198,0,368802,2125000,585399,0.0,122934.0,708333,2066116,0,433884,2500000,688705,0.0,144628.0,833333
3174445,2623508,0,550937,3174445,874502,0.0,183645.67,1058148,3747869,0,787052,4534921,1249289,0.0,262350.67,1511640
2466000,2038016,0,427984,2466000,679338,0.0,142661.33,822000,2717355,0,570645,3288000,905785,0.0,190215.0,1096000
2400000,1983471,0,416529,2400000,661157,0.0,138843.0,800000,2644628,0,555372,3200000,881542,0.0,185124.0,1066667
2425000,2004132,0,420868,2425000,668044,0.0,140289.33,808333,2672176,0,561157,3233333,890725,0.0,187052.33,1077778
1316400,1087933,0,228467,1316400,362644,0.0,76155.67,438800,1450577,0,304623,1755200,483525,0.0,101541.0,585067
3302367,2729229,0,573138,3302367,909743,0.0,191046.0,1100789,3638972,0,764184,4403156,1212990,0.0,254728.0,1467719
1958000,1618181,0,339819,1958000,539393,0.0,113273.0,652667,2157575,0,453092,2610667,719191,0.0,151030.67,870222
1490250,1231612,0,258638,1490250,410537,0.0,86212.67,496750,1642149,0,344851,1987000,547383,0.0,114950.33,662333
5324000,4400000,0,924000,5324000,1466666,0.0,308000.0,1774667,5214876,0,1095124,6310000,1738292,0.0,365041.33,2103333
12000000,9917355,0,2082645,12000000,3305785,0.0,694215.0,4000000,13223140,0,2776860,16000000,4407713,0.0,925620.0,5333333
9238750,7635331,0,1603419,9238750,2545110,0.0,534473.0,3079583,10180441,0,2137892,12318333,3393480,0.0,712630.67,4106111
6126030,5062835,0,1063195,6126030,1687611,0.0,354398.33,2042010,6750447,0,1417593,8168040,2250149,0.0,472531.0,2722680
7937600,6560000,1377600,0,7937600,2186666,459200.0,0.0,2645867,8746667,1836800,0,10583467,2915555,612266.67,0.0,3527822
8102514,6696294,1406220,0,8102514,2232098,468740.0,0.0,2700838,8928392,1874960,0,10803352,2976130,624986.67,0.0,3601117
6126030,5062835,0,1063195,6126030,1687611,0.0,354398.33,2042010,6750447,0,1417593,8168040,2250149,0.0,472531.0,2722680
5475252,4525000,950252,0,5475252,1508333,316750.67,0.0,1825084,6033333,1267003,0,7300336,2011111,422334.33,0.0,2433445
7937600,6560000,1377600,0,7937600,2186666,459200.0,0.0,2645867,8746667,1836800,0,10583467,2915555,612266.67,0.0,3527822
9445000,7805786,0,1639214,9445000,2601928,0.0,546404.67,3148333,10407715,0,2185618,12593333,3469238,0.0,728539.33,4197778
10491736,8670857,0,1820879,10491736,2890285,0.0,606959.67,3497245,11561143,0,2427838,13988981,3853714,0.0,809279.33,4662994
3089997,2553717,0,536280,3089997,851239,0.0,178760.0,1029999,3404956,0,715040,4119996,1134985,0.0,238346.67,1373332
14670000,12123967,0,2546033,14670000,4041322,0.0,848677.67,4890000,16165289,0,3394711,19560000,5388429,0.0,1131570.33,6520000
5343099,4415785,0,927314,5343099,1471928,0.0,309104.67,1781033,5887713,0,1236419,7124132,1962571,0.0,412139.67,2374711
5999999,4958677,0,1041322,5999999,1652892,0.0,347107.33,2000000,6611569,0,1388430,7999999,2203856,0.0,462810.0,2666666
3631109,3000916,0,630193,3631109,1000305,0.0,210064.33,1210370,4001221,0,840258,4841479,1333740,0.0,280086.0,1613826
6554000,5416529,0,1137471,6554000,1805509,0.0,379157.0,2184667,7222039,0,1516628,8738667,2407346,0.0,505542.67,2912889
9047000,7476860,0,1570140,9047000,2492286,0.0,523380.0,3015667,9969147,0,2093520,12062667,3323049,0.0,697840.0,4020889
4050000,3347107,0,702893,4050000,1115702,0.0,234297.67,1350000,4462809,0,937191,5400000,1487603,0.0,312397.0,1800000
9445000,7805786,0,1639214,9445000,2601928,0.0,546404.67,3148333,10407715,0,2185618,12593333,3469238,0.0,728539.33,4197778
3845555,3178145,0,667410,3845555,1059381,0.0,222470.0,1281852,3746555,0,786777,4533332,1248851,0.0,262259.0,1511111
6200000,5123967,0,1076033,6200000,1707989,0.0,358677.67,2066667,6831956,0,1434711,8266667,2277318,0.0,478237.0,2755556
13811684,11414615,0,2397069,13811684,3804871,0.0,799023.0,4603895,15219487,0,3196092,18415579,5073162,0.0,1065364.0,6138526
4676400,3864794,0,811606,4676400,1288264,0.0,270535.33,1558800,5153059,0,1082141,6235200,1717686,0.0,360713.67,2078400
3455000,2855372,0,599628,3455000,951790,0.0,199876.0,1151667,3807163,0,799504,4606667,1269054,0.0,266501.33,1535556
3327000,2749587,0,577413,3327000,916529,0.0,192471.0,1109000,3666116,0,769884,4436000,1222038,0.0,256628.0,1478667
4368000,3609918,0,758082,4368000,1203306,0.0,252694.0,1456000,7520661,0,1579339,9100000,2506887,0.0,526446.33,3033333
4204541,3474827,0,729714,4204541,1158275,0.0,243238.0,1401514,4343534,0,912142,5255676,1447844,0.0,304047.33,1751892
7500000,6198348,0,1301652,7500000,2066116,0.0,433884.0,2500000,8264464,0,1735536,10000000,2754821,0.0,578512.0,3333333
8300000,6859505,0,1440495,8300000,2286501,0.0,480165.0,2766667,7438017,0,1561983,9000000,2479339,0.0,520661.0,3000000
4853320,4011009,0,842311,4853320,1337003,0.0,280770.33,1617773,5348012,0,1123081,6471093,1782670,0.0,374360.33,2157031
5360259,4429965,0,930294,5360259,1476655,0.0,310098.0,1786753,7107743,0,1492626,8600369,2369247,0.0,497542.0,2866790
3720000,3074380,0,645620,3720000,1024793,0.0,215206.67,1240000,4099173,0,860827,4960000,1366391,0.0,286942.33,1653333
13192650,10903016,0,2289634,13192650,3634338,0.0,763211.33,4397550,14537355,0,3052845,17590200,4845785,0.0,1017615.0,5863400
10500000,8677686,0,1822314,10500000,2892562,0.0,607438.0,3500000,11570248,0,2429752,14000000,3856749,0.0,809917.33,4666667
3754699,3103057,0,651642,3754699,1034352,0.0,217214.0,1251566,4137409,0,868856,5006265,1379136,0.0,289618.67,1668755
2900000,2396694,0,503306,2900000,798898,0.0,167768.67,966667,3195592,0,671075,3866667,1065197,0.0,223691.67,1288889
4566200,3773719,0,792481,4566200,1257906,0.0,264160.33,1522067,4439669,0,932331,5372000,1479889,0.0,310777.0,1790667
4705778,3889072,0,816706,4705778,1296357,0.0,272235.33,1568593,8838801,0,1856148,10694949,2946267,0.0,618716.0,3564983
2929998,2421486,0,508512,2929998,807162,0.0,169504.0,976666,3228648,0,678016,3906664,1076216,0.0,226005.33,1302221
2635000,2177686,0,457314,2635000,725895,0.0,152438.0,878333,2903581,0,609752,3513333,967860,0.0,203250.67,1171111
3749999,3099174,650825,0,3749999,1033058,216941.67,0.0,1250000,4132232,867767,0,4999999,1377410,289255.67,0.0,1666666
5500000,4545455,0,954545,5500000,1515151,0.0,318181.67,1833333,6060607,0,1272726,7333333,2020202,0.0,424242.0,2444444
3666663,3030300,0,636363,3666663,1010100,0.0,212121.0,1222221,4040400,0,848484,4888884,1346800,0.0,282828.0,1629628
4739998,3917353,0,822645,4739998,1305784,0.0,274215.0,1579999,5223137,0,1096860,6319997,1741045,0.0,365620.0,2106666
2188800,1808925,0,379875,2188800,602975,0.0,126625.0,729600,2261158,0,474842,2736000,753719,0.0,158280.67,912000
4191440,3464000,0,727440,4191440,1154666,0.0,242480.0,1397147,4618667,0,969920,5588587,1539555,0.0,323306.67,1862862
1783000,1543723,0,239277,1783000,514574,0.0,79759.0,594333,2058297,0,319036,2377333,686099,0.0,106345.33,792444
2094400,1730909,0,363491,2094400,576969,0.0,121163.67,698133,2307879,0,484654,2792533,769293,0.0,161551.33,930844
2094400,1730909,0,363491,2094400,576969,0.0,121163.67,698133,2307879,0,484654,2792533,769293,0.0,161551.33,930844
2100000,1719903,0,380097,2100000,573301,0.0,126699.0,700000,2293204,0,506796,2800000,764401,0.0,168932.0,933333
6824000,5639669,0,1184331,6824000,1879889,0.0,394777.0,2274667,7519559,0,1579108,9098667,2506519,0.0,526369.33,3032889
5900000,4876034,0,1023966,5900000,1625344,0.0,341322.0,1966667,6501379,0,1365288,7866667,2167126,0.0,455096.0,2622222
5900000,4876034,0,1023966,5900000,1625344,0.0,341322.0,1966667,6501379,0,1365288,7866667,2167126,0.0,455096.0,2622222
8400000,6942150,0,1457850,8400000,2314050,0.0,485950.0,2800000,9917355,0,2082645,12000000,3305785,0.0,694215.0,4000000
3220000,2661158,0,558842,3220000,887052,0.0,186280.67,1073333,3548211,0,745122,4293333,1182737,0.0,248374.0,1431111
4400000,3636364,0,763636,4400000,1212121,0.0,254545.33,1466667,4848485,0,1018182,5866667,1616161,0.0,339394.0,1955556
1192307,985378,0,206929,1192307,328459,0.0,68976.33,397436,1313837,0,275906,1589743,437945,0.0,91968.67,529914
4000000,3305786,0,694214,4000000,1101928,0.0,231404.67,1333333,4407715,0,925618,5333333,1469238,0.0,308539.33,1777778
1770000,1462809,0,307191,1770000,487603,0.0,102397.0,590000,1950412,0,409588,2360000,650137,0.0,136529.33,786667
2050000,1694214,0,355786,2050000,564738,0.0,118595.33,683333,2258952,0,474381,2733333,752984,0.0,158127.0,911111
3150000,2603307,0,546693,3150000,867769,0.0,182231.0,1050000,8677686,0,1822314,10500000,2892562,0.0,607438.0,3500000
1063500,878926,0,184574,1063500,292975,0.0,61524.67,354500,892562,0,187438,1080000,297520,0.0,62479.33,360000
1550000,1280991,0,269009,1550000,426997,0.0,89669.67,516667,1707988,0,358679,2066667,569329,0.0,119559.67,688889
4000000,3305786,0,694214,4000000,1101928,0.0,231404.67,1333333,4407715,0,925618,5333333,1469238,0.0,308539.33,1777778
1185000,979338,0,205662,1185000,326446,0.0,68554.0,395000,1305784,0,274216,1580000,435261,0.0,91405.33,526667
2100000,1719903,0,380097,2100000,573301,0.0,126699.0,700000,2293204,0,506796,2800000,764401,0.0,168932.0,933333
22000000,18181817,0,3818183,22000000,6060605,0.0,1272727.67,7333333,24242423,0,5090910,29333333,8080807,0.0,1696970.0,9777778
1300000,1074380,0,225620,1300000,358126,0.0,75206.67,433333,1432507,0,300826,1733333,477502,0.0,100275.33,577778
420000,347106,0,72894,420000,115702,0.0,24298.0,140000,462808,0,97192,560000,154269,0.0,32397.33,186667
2550000,2107438,0,442562,2550000,702479,0.0,147520.67,850000,2809917,0,590083,3400000,936639,0.0,196694.33,1133333
1110938,918130,0,192808,1110938,306043,0.0,64269.33,370313,1224173,0,257078,1481251,408057,0.0,85692.67,493750
1234000,1019835,0,214165,1234000,339945,0.0,71388.33,411333,1359780,0,285553,1645333,453260,0.0,95184.33,548444
1052500,869834,0,182666,1052500,289944,0.0,60888.67,350833,1159779,0,243554,1403333,386593,0.0,81184.67,467778
2584000,2135537,448463,0,2584000,711845,149487.67,0.0,861333,3371901,448463,0,3820364,1123967,149487.67,0.0,1273455
5779000,4776033,0,1002967,5779000,1592011,0.0,334322.33,1926333,5785124,0,1214876,7000000,1928374,0.0,404958.67,2333333
3607600,2981488,0,626112,3607600,993829,0.0,208704.0,1202533,3975317,0,834816,4810133,1325105,0.0,278272.0,1603378
5541801,4580000,961801,0,5541801,1526666,320600.33,0.0,1847267,6106667,1282401,0,7389068,2035555,427467.0,0.0,2463023
3607600,2981488,0,626112,3607600,993829,0.0,208704.0,1202533,3975317,0,834816,4810133,1325105,0.0,278272.0,1603378
3188500,2635124,0,553376,3188500,878374,0.0,184458.67,1062833,3513499,0,737834,4251333,1171166,0.0,245944.67,1417111
6081349,5025908,0,1055441,6081349,1675302,0.0,351813.67,2027116,5190908,0,1090091,6280999,1730302,0.0,363363.67,2093666
6909101,5710000,1199101,0,6909101,1903333,399700.33,0.0,2303034,7613333,1598801,0,9212134,2537777,532933.67,0.0,3070711
2323050,1919876,0,403174,2323050,639958,0.0,134391.33,774350,2018182,0,423818,2442000,672727,0.0,141272.67,814000
5130400,4240000,0,890400,5130400,1413333,0.0,296800.0,1710133,5653333,0,1187200,6840533,1884444,0.0,395733.33,2280178
2073360,1713520,0,359840,2073360,571173,0.0,119946.67,691120,2284693,0,479787,2764480,761564,0.0,159929.0,921493
8464000,6995041,0,1468959,8464000,2331680,0.0,489653.0,2821333,9326721,0,1958612,11285333,3108907,0.0,652870.67,3761778
7332600,6060000,1272600,0,7332600,2020000,424200.0,0.0,2444200,8080000,1696800,0,9776800,2693333,565600.0,0.0,3258933
13200000,10909091,0,2290909,13200000,3636363,0.0,763636.33,4400000,14545455,0,3054545,17600000,4848485,0.0,1018181.67,5866667
2747651,2270786,0,476865,2747651,756928,0.0,158955.0,915884,3662557,0,769137,4431694,1220852,0.0,256379.0,1477231
1839997,1520659,0,319338,1839997,506886,0.0,106446.0,613332,2027545,0,425784,2453329,675848,0.0,141928.0,817776
4786000,3955371,0,830629,4786000,1318457,0.0,276876.33,1595333,5273828,0,1107505,6381333,1757942,0.0,369168.33,2127111
1995000,1648760,0,346240,1995000,549586,0.0,115413.33,665000,2198347,0,461653,2660000,732782,0.0,153884.33,886667
2247132,1857134,0,389998,2247132,619044,0.0,129999.33,749044,3714266,0,779996,4494262,1238088,0.0,259998.67,1498087
1966583,1625275,0,341308,1966583,541758,0.0,113769.33,655528,2068677,0,434423,2503100,689559,0.0,144807.67,834367
3881775,3208079,0,673696,3881775,1069359,0.0,224565.33,1293925,4277439,0,898261,5175700,1425813,0.0,299420.33,1725233
6270000,5181818,0,1088182,6270000,1727272,0.0,362727.33,2090000,6909091,0,1450909,8360000,2303030,0.0,483636.33,2786667
3675000,3037191,0,637809,3675000,1012397,0.0,212603.0,1225000,4049588,0,850412,4900000,1349862,0.0,283470.67,1633333
2635000,2177686,0,457314,2635000,725895,0.0,152438.0,878333,2903581,0,609752,3513333,967860,0.0,203250.67,1171111
3036900,2509835,0,527065,3036900,836611,0.0,175688.33,1012300,2568967,0,539483,3108450,856322,0.0,179827.67,1036150
2386000,1971901,0,414099,2386000,657300,0.0,138033.0,795333,2629201,0,552132,3181333,876400,0.0,184044.0,1060444
1591200,1315041,0,276159,1591200,438347,0.0,92053.0,530400,1753388,0,368212,2121600,584462,0.0,122737.33,707200
2144000,1771901,0,372099,2144000,590633,0.0,124033.0,714667,2362535,0,496132,2858667,787511,0.0,165377.33,952889
1364998,1181817,0,183181,1364998,393939,0.0,61060.33,454999,1575756,0,244241,1819997,525252,0.0,81413.67,606666
1022880,885611,0,137269,1022880,295203,0.0,45756.33,340960,955845,0,148155,1104000,318615,0.0,49385.0,368000
1166000,1009524,0,156476,1166000,336508,0.0,52158.67,388667,1346032,0,208635,1554667,448677,0.0,69545.0,518222
1399997,1157023,0,242974,1399997,385674,0.0,80991.33,466666,1542697,0,323966,1866663,514232,0.0,107988.67,622221
1550000,1280992,0,269008,1550000,426997,0.0,89669.33,516667,1707989,0,358678,2066667,569329,0.0,119559.33,688889
1116000,922315,0,193685,1116000,307438,0.0,64561.67,372000,1024793,0,215207,1240000,341597,0.0,71735.67,413333
1389997,1148758,0,241239,1389997,382919,0.0,80413.0,463332,1531677,0,321652,1853329,510559,0.0,107217.33,617776
1365000,1128100,0,236900,1365000,376033,0.0,78966.67,455000,1504133,0,315867,1820000,501377,0.0,105289.0,606667
1640000,1355372,0,284628,1640000,451790,0.0,94876.0,546667,1807163,0,379504,2186667,602387,0.0,126501.33,728889
1039997,859501,0,180496,1039997,286500,0.0,60165.33,346666,1146001,0,240662,1386663,382000,0.0,80220.67,462221
1400000,1157024,0,242976,1400000,385674,0.0,80992.0,466667,1542699,0,323968,1866667,514233,0.0,107989.33,622222
5803300,4796116,0,1007184,5803300,1598705,0.0,335728.0,1934433,6394821,0,1342912,7737733,2131607,0.0,447637.33,2579244
1675000,1384297,0,290703,1675000,461432,0.0,96901.0,558333,1845729,0,387604,2233333,615243,0.0,129201.33,744444
1360000,1123967,0,236033,1360000,374655,0.0,78677.67,453333,1498623,0,314710,1813333,499541,0.0,104903.33,604444
2323050,1919876,0,403174,2323050,639958,0.0,134391.33,774350,2018182,0,423818,2442000,672727,0.0,141272.67,814000
3569768,2950221,0,619547,3569768,983407,0.0,206515.67,1189923,3933628,0,826062,4759690,1311209,0.0,275354.0,1586563
2400000,1983471,0,416529,2400000,661157,0.0,138843.0,800000,2644628,0,555372,3200000,881542,0.0,185124.0,1066667
995000,822315,0,172685,995000,274105,0.0,57561.67,331667,1096420,0,230247,1326667,365473,0.0,76749.0,442222
1575000,1301653,0,273347,1575000,433884,0.0,91115.67,525000,1735537,0,364463,2100000,578512,0.0,121487.67,700000
2144493,1772309,0,372184,2144493,590769,0.0,124061.33,714831,2363079,0,496245,2859324,787693,0.0,165415.0,953108
1800000,1487604,0,312396,1800000,495868,0.0,104132.0,600000,1983472,0,416528,2400000,661157,0.0,138842.67,800000
939997,776857,0,163140,939997,258952,0.0,54380.0,313332,1035809,0,217520,1253329,345269,0.0,72506.67,417776
4023821,3325472,0,698349,4023821,1108490,0.0,232783.0,1341274,4433963,0,931132,5365095,1477987,0.0,310377.33,1788365
2920000,2413222,0,506778,2920000,804407,0.0,168926.0,973333,3217629,0,675704,3893333,1072543,0.0,225234.67,1297778
2070000,1710743,0,359257,2070000,570247,0.0,119752.33,690000,2280991,0,479009,2760000,760330,0.0,159669.67,920000
1140000,942150,0,197850,1140000,314050,0.0,65950.0,380000,1256200,0,263800,1520000,418733,0.0,87933.33,506667
5600000,4628099,0,971901,5600000,2314049,0.0,485950.5,2800000,6170799,0,1295868,7466667,3085399,0.0,647934.0,3733334
4506827,3724650,782177,0,4506827,1862325,391088.5,0.0,2253414,4169650,782177,0,4951827,2084825,391088.5,0.0,2475914
2916100,2410000,506100,0,2916100,1205000,253050.0,0.0,1458050,3213333,674800,0,3888133,1606666,337400.0,0.0,1944066
7545780,6580832,0,964948,7545780,3290416,0.0,482474.0,3772890,8774443,0,1286597,10061040,4387221,0.0,643298.5,5030520
2408000,1990082,0,417918,2408000,995041,0.0,208959.0,1204000,2653443,0,557224,3210667,1326721,0.0,278612.0,1605334
7229001,5974381,0,1254620,7229001,2987190,0.0,627310.0,3614500,7965841,0,1672827,9638668,3982920,0.0,836413.5,4819334
5350000,4421488,0,928512,5350000,2210744,0.0,464256.0,2675000,4752067,0,997933,5750000,2376033,0.0,498966.5,2875000
5316001,4393389,0,922612,5316001,2196694,0.0,461306.0,2658000,5857852,0,1230149,7088001,2928926,0.0,615074.5,3544000
3300000,2727273,0,572727,3300000,1363636,0.0,286363.5,1650000,3636364,0,763636,4400000,1818182,0.0,381818.0,2200000
874000,722314,0,151686,874000,361157,0.0,75843.0,437000,963085,0,202248,1165333,481542,0.0,101124.0,582666
16012293,13233300,0,2778993,16012293,6616650,0.0,1389496.5,8006146,17644400,0,3705324,21349724,8822200,0.0,1852662.0,10674862
11132000,9200000,0,1932000,11132000,4600000,0.0,966000.0,5566000,12266667,0,2576000,14842667,6133333,0.0,1288000.0,7421334
17972917,14853650,0,3119267,17972917,7426825,0.0,1559633.5,8986458,16058000,0,3372180,19430180,8029000,0.0,1686090.0,9715090
2850760,2356000,0,494760,2850760,1178000,0.0,247380.0,1425380,3141333,0,659680,3801013,1570666,0.0,329840.0,1900506
2050000,1694215,0,355785,2050000,847107,0.0,177892.5,1025000,2258953,0,474380,2733333,1129476,0.0,237190.0,1366666
17545000,14500000,3045000,0,17545000,7250000,1522500.0,0.0,8772500,19333333,4060000,0,23393333,9666666,2030000.0,0.0,11696666
2408000,1990082,0,417918,2408000,995041,0.0,208959.0,1204000,2653443,0,557224,3210667,1326721,0.0,278612.0,1605334
5865167,4847245,0,1017922,5865167,2423622,0.0,508961.0,2932584,8544323,0,0,8544323,4272161,0.0,0.0,4272162
2984000,2466116,0,517884,2984000,1233058,0.0,258942.0,1492000,3288155,0,690512,3978667,1644077,0.0,345256.0,1989334
4870000,4024793,0,845207,4870000,2012396,0.0,422603.5,2435000,5366391,0,1126942,6493333,2683195,0.0,563471.0,3246666
5263500,4350000,913500,0,5263500,2175000,456750.0,0.0,2631750,5800000,1218000,0,7018000,2900000,609000.0,0.0,3509000
2150000,1776860,0,373140,2150000,888430,0.0,186570.0,1075000,2369147,0,497520,2866667,1184573,0.0,248760.0,1433334
2600000,2148760,0,451240,2600000,1074380,0.0,225620.0,1300000,2865013,0,601654,3466667,1432506,0.0,300827.0,1733334
2554310,2111000,0,443310,2554310,1055500,0.0,221655.0,1277155,2814667,0,591080,3405747,1407333,0.0,295540.0,1702874
3361776,2778327,0,583449,3361776,1389163,0.0,291724.5,1680888,3704436,0,777932,4482368,1852218,0.0,388966.0,2241184
11444641,9756326,803982,884333,11444641,4878163,401991.0,442166.5,5722320,13008435,1071976,1179111,15259522,6504217,535988.0,589555.5,7629761
7230960,5976000,1254960,0,7230960,2988000,627480.0,0.0,3615480,7968000,1673280,0,9641280,3984000,836640.0,0.0,4820640
6156378,5087916,0,1068462,6156378,2543958,0.0,534231.0,3078189,5653239,0,1187181,6840420,2826619,0.0,593590.5,3420210
4325000,3574380,0,750620,4325000,1787190,0.0,375310.0,2162500,4765840,0,1000827,5766667,2382920,0.0,500413.5,2883334
4320000,3570248,0,749752,4320000,1785124,0.0,374876.0,2160000,5950414,0,1249586,7200000,2975207,0.0,624793.0,3600000
2670000,2206611,0,463389,2670000,1103305,0.0,231694.5,1335000,2942148,0,617852,3560000,1471074,0.0,308926.0,1780000
9993390,8259000,1734390,0,9993390,4129500,867195.0,0.0,4996695,11012000,2312520,0,13324520,5506000,1156260.0,0.0,6662260
2857000,2361157,0,495843,2857000,1180578,0.0,247921.5,1428500,3148209,0,661124,3809333,1574104,0.0,330562.0,1904666
3881776,3208079,0,673697,3881776,1604039,0.0,336848.5,1940888,4277439,0,898262,5175701,2138719,0.0,449131.0,2587850
2880000,2380165,0,499835,2880000,1190082,0.0,249917.5,1440000,3173553,0,666447,3840000,1586776,0.0,333223.5,1920000
2150000,1776859,0,373141,2150000,888429,0.0,186570.5,1075000,2369145,0,497522,2866667,1184572,0.0,248761.0,1433334
2850000,2355372,0,494628,2850000,1177686,0.0,247314.0,1425000,3140496,0,659504,3800000,1570248,0.0,329752.0,1900000
5293750,4375000,0,918750,5293750,2187500,0.0,459375.0,2646875,4950000,0,1039500,5989500,2475000,0.0,519750.0,2994750
3871580,3300507,271910,299163,3871580,1650253,135955.0,149581.5,1935790,4400676,362598,398937,5162211,2200338,181299.0,199468.5,2581106
3726800,3080000,646800,0,3726800,1540000,323400.0,0.0,1863400,4106667,862400,0,4969067,2053333,431200.0,0.0,2484534
7126900,5890000,1236900,0,7126900,2945000,618450.0,0.0,3563450,7853333,1649200,0,9502533,3926666,824600.0,0.0,4751266
4200000,3471075,0,728925,4200000,1735537,0.0,364462.5,2100000,4628100,0,971900,5600000,2314050,0.0,485950.0,2800000
13068000,10800000,2268000,0,13068000,5400000,1134000.0,0.0,6534000,14400000,3024000,0,17424000,7200000,1512000.0,0.0,8712000
2339810,1933728,0,406082,2339810,966864,0.0,203041.0,1169905,2578304,0,541443,3119747,1289152,0.0,270721.5,1559874
2661452,2199547,0,461905,2661452,1099773,0.0,230952.5,1330726,2932729,0,615874,3548603,1466364,0.0,307937.0,1774302
6776000,5600000,1176000,0,6776000,2800000,588000.0,0.0,3388000,7466667,1568000,0,9034667,3733333,784000.0,0.0,4517334
2094000,1730578,0,363422,2094000,865289,0.0,181711.0,1047000,2307437,0,484563,2792000,1153718,0.0,242281.5,1396000
1725000,1425620,0,299380,1725000,712810,0.0,149690.0,862500,1549587,0,325413,1875000,774793,0.0,162706.5,937500
10640356,8793680,1846676,0,10640356,4396840,923338.0,0.0,5320178,11724907,2462235,0,14187142,5862453,1231117.5,0.0,7093571
2730000,2256199,0,473801,2730000,1128099,0.0,236900.5,1365000,3008265,0,631735,3640000,1504132,0.0,315867.5,1820000
2236676,1906500,157257,172919,2236676,953250,78628.5,86459.5,1118338,2541948,209728,230559,2982235,1270974,104864.0,115279.5,1491118
1943750,1606405,0,337345,1943750,803202,0.0,168672.5,971875,1745868,0,366632,2112500,872934,0.0,183316.0,1056250
3202100,2646363,0,555737,3202100,1323181,0.0,277868.5,1601050,2700826,0,567174,3268000,1350413,0.0,283587.0,1634000
1985000,1640496,0,344504,1985000,820248,0.0,172252.0,992500,2187328,0,459339,2646667,1093664,0.0,229669.5,1323334
4198380,3469735,0,728645,4198380,1734867,0.0,364322.5,2099190,4626313,0,971527,5597840,2313156,0.0,485763.5,2798920
3528360,2916000,612360,0,3528360,1458000,306180.0,0.0,1764180,3888000,816480,0,4704480,1944000,408240.0,0.0,2352240
1266000,1046281,0,219719,1266000,523140,0.0,109859.5,633000,1395041,0,292959,1688000,697520,0.0,146479.5,844000
2176000,1798347,0,377653,2176000,899173,0.0,188826.5,1088000,2397796,0,503537,2901333,1198898,0.0,251768.5,1450666
17036800,14080000,0,2956800,17036800,7040000,0.0,1478400.0,8518400,18773333,0,3942400,22715733,9386666,0.0,1971200.0,11357866
1250000,1033058,0,216942,1250000,516529,0.0,108471.0,625000,1377411,0,289256,1666667,688705,0.0,144628.0,833334
1645000,1359504,0,285496,1645000,679752,0.0,142748.0,822500,1812672,0,380661,2193333,906336,0.0,190330.5,1096666
2166666,1790633,0,376033,2166666,895316,0.0,188016.5,1083333,2387511,0,501377,2888888,1193755,0.0,250688.5,1444444
2893170,2391050,502120,0,2893170,1195525,251060.0,0.0,1446585,3188067,669493,0,3857560,1594033,334746.5,0.0,1928780
2547500,2105372,0,442128,2547500,1052686,0.0,221064.0,1273750,2807163,0,589504,3396667,1403581,0.0,294752.0,1698334
3365556,2781451,0,584105,3365556,1390725,0.0,292052.5,1682778,3708601,0,778807,4487408,1854300,0.0,389403.5,2243704
4513300,3730000,783300,0,4513300,1865000,391650.0,0.0,2256650,4973333,1044400,0,6017733,2486666,522200.0,0.0,3008866
4045556,3343435,0,702121,4045556,1671717,0.0,351060.5,2022778,4457913,0,936162,5394075,2228956,0.0,468081.0,2697038
6776000,5600000,1176000,0,6776000,2800000,588000.0,0.0,3388000,7466667,1568000,0,9034667,3733333,784000.0,0.0,4517334
9855316,8401320,692305,761691,9855316,4200660,346152.5,380845.5,4927658,11201708,923021,1015589,13140318,5600854,461510.5,507794.5,6570159
3291266,2805870,231186,254210,3291266,1402935,115593.0,127105.0,1645633,3741108,308248,338947,4388303,1870554,154124.0,169473.5,2194152
2837451,2345000,492451,0,2837451,1172500,246225.5,0.0,1418726,3126667,656601,0,3783268,1563333,328300.5,0.0,1891634
2139999,1768595,371404,0,2139999,884297,185702.0,0.0,1070000,2358127,495205,0,2853332,1179063,247602.5,0.0,1426666
563000,465289,0,97711,563000,232644,0.0,48855.5,281500,620385,0,130282,750667,310192,0.0,65141.0,375334
2528300,2089504,0,438796,2528300,1044752,0.0,219398.0,1264150,2786005,0,585062,3371067,1393002,0.0,292531.0,1685534
4776119,4071440,335658,369021,4776119,2035720,167829.0,184510.5,2388060,5428639,447492,491975,6368106,2714319,223746.0,245987.5,3184053
2100000,1735537,0,364463,2100000,867768,0.0,182231.5,1050000,2314050,0,485950,2800000,1157025,0.0,242975.0,1400000
7937600,6560000,0,1377600,7937600,3280000,0.0,688800.0,3968800,8000000,0,1680000,9680000,4000000,0.0,840000.0,4840000
6041638,4993089,0,1048549,6041638,2496544,0.0,524274.5,3020819,5088589,0,1068604,6157193,2544294,0.0,534302.0,3078596
7167900,5923884,0,1244016,7167900,2961942,0.0,622008.0,3583950,7898512,0,1658688,9557200,3949256,0.0,829344.0,4778600
4513300,3730000,783300,0,4513300,1865000,391650.0,0.0,2256650,4973333,1044400,0,6017733,2486666,522200.0,0.0,3008866
6413000,5300000,1113000,0,6413000,2650000,556500.0,0.0,3206500,7066667,1484000,0,8550667,3533333,742000.0,0.0,4275334
3820000,3157024,0,662976,3820000,1578512,0.0,331488.0,1910000,4209365,0,883968,5093333,2104682,0.0,441984.0,2546666
1294000,1069421,0,224579,1294000,534710,0.0,112289.5,647000,1425895,0,299438,1725333,712947,0.0,149719.0,862666
5055555,4178145,0,877410,5055555,2089072,0.0,438705.0,2527778,5968778,0,1253443,7222221,2984389,0.0,626721.5,3611110
3473100,2870331,602769,0,3473100,1435165,301384.5,0.0,1736550,3752066,602769,0,4354835,1876033,301384.5,0.0,2177418
4250000,3512397,0,737603,4250000,1756198,0.0,368801.5,2125000,4683196,0,983471,5666667,2341598,0.0,491735.5,2833334
4540800,3752727,0,788073,4540800,1876363,0.0,394036.5,2270400,4690909,0,985091,5676000,2345454,0.0,492545.5,2838000
1398000,1155372,0,242628,1398000,577686,0.0,121314.0,699000,1540496,0,323504,1864000,770248,0.0,161752.0,932000
7650000,6322314,0,1327686,7650000,3161157,0.0,663843.0,3825000,8429752,0,1770248,10200000,4214876,0.0,885124.0,5100000
4537500,3750000,787500,0,4537500,1875000,393750.0,0.0,2268750,5000000,1050000,0,6050000,2500000,525000.0,0.0,3025000
2450000,2024793,0,425207,2450000,1012396,0.0,212603.5,1225000,2699724,0,566943,3266667,1349862,0.0,283471.5,1633334
2502000,2067769,0,434231,2502000,1033884,0.0,217115.5,1251000,2757025,0,578975,3336000,1378512,0.0,289487.5,1668000
2296250,1897728,0,398522,2296250,948864,0.0,199261.0,1148125,2520662,0,529338,3050000,1260331,0.0,264669.0,1525000
2170000,1793388,0,376612,2170000,896694,0.0,188306.0,1085000,2391184,0,502149,2893333,1195592,0.0,251074.5,1446666
2223000,1837190,0,385810,2223000,918595,0.0,192905.0,1111500,2449587,0,514413,2964000,1224793,0.0,257206.5,1482000
2001999,1654545,347454,0,2001999,827272,173727.0,0.0,1001000,2206060,463272,0,2669332,1103030,231636.0,0.0,1334666
8320000,6876033,0,1443967,8320000,3438016,0.0,721983.5,4160000,9168044,0,1925289,11093333,4584022,0.0,962644.5,5546666
2398000,1981818,0,416182,2398000,990909,0.0,208091.0,1199000,2642424,0,554909,3197333,1321212,0.0,277454.5,1598666
1715255,1417566,0,297689,1715255,708783,0.0,148844.5,857628,2498718,0,0,2498718,1249359,0.0,0.0,1249359
3429997,2834710,595287,0,3429997,1417355,297643.5,0.0,1714998,3779613,793716,0,4573329,1889806,396858.0,0.0,2286664
2700000,2231405,0,468595,2700000,1115702,0.0,234297.5,1350000,2975207,0,624793,3600000,1487603,0.0,312396.5,1800000
1420000,1173554,0,246446,1420000,586777,0.0,123223.0,710000,1564739,0,328594,1893333,782369,0.0,164297.0,946666
1098000,907438,0,190562,1098000,453719,0.0,95281.0,549000,1209917,0,254083,1464000,604958,0.0,127041.5,732000
4247312,3510175,0,737137,4247312,1755087,0.0,368568.5,2123656,4680233,0,982850,5663083,2340116,0.0,491425.0,2831542
1949971,1611546,338425,0,1949971,805773,169212.5,0.0,974986,2148728,451233,0,2599961,1074364,225616.5,0.0,1299980
3476000,2872728,0,603272,3476000,1436364,0.0,301636.0,1738000,3830304,0,804363,4634667,1915152,0.0,402181.5,2317334
3937500,3254132,0,683368,3937500,1627066,0.0,341684.0,1968750,4338843,0,911157,5250000,2169421,0.0,455578.5,2625000
1471000,1215702,0,255298,1471000,607851,0.0,127649.0,735500,1388429,0,291571,1680000,694214,0.0,145785.5,840000
1686000,1393389,0,292611,1686000,696694,0.0,146305.5,843000,1857852,0,390148,2248000,928926,0.0,195074.0,1124000
5566315,4600261,0,966054,5566315,2300130,0.0,483027.0,2783158,6133681,0,1288072,7421753,3066840,0.0,644036.0,3710876
1850270,1529148,0,321122,1850270,764574,0.0,160561.0,925135,2695446,0,0,2695446,1347723,0.0,0.0,1347723
2944446,2433426,0,511020,2944446,1216713,0.0,255510.0,1472223,3244568,0,681360,3925928,1622284,0.0,340680.0,1962964
2222941,1837141,0,385800,2222941,918570,0.0,192900.0,1111470,2449521,0,514400,2963921,1224760,0.0,257200.0,1481960
1673682,1383208,0,290474,1673682,691604,0.0,145237.0,836841,1844277,0,387299,2231576,922138,0.0,193649.5,1115788
1666666,1377410,0,289256,1666666,688705,0.0,144628.0,833333,1836547,0,385674,2222221,918273,0.0,192837.0,1111110
2837451,2345000,492451,0,2837451,1172500,246225.5,0.0,1418726,3126667,656601,0,3783268,1563333,328300.5,0.0,1891634
5000000,4132232,0,867768,5000000,2066116,0.0,433884.0,2500000,5509643,0,1157024,6666667,2754821,0.0,578512.0,3333334
5488562,4536000,952562,0,5488562,2268000,476281.0,0.0,2744281,6048000,1270083,0,7318083,3024000,635041.5,0.0,3659042
1150000,950413,0,199587,1150000,475206,0.0,99793.5,575000,1267217,0,266116,1533333,633608,0.0,133058.0,766666
700000,578513,0,121487,700000,289256,0.0,60743.5,350000,771351,0,161982,933333,385675,0.0,80991.0,466666
1265511,1045877,0,219634,1265511,522938,0.0,109817.0,632756,1394503,0,292845,1687348,697251,0.0,146422.5,843674
2419199,1999338,419861,0,2419199,999669,209930.5,0.0,1209600,2221486,419861,0,2641347,1110743,209930.5,0.0,1320674
850000,702480,0,147520,850000,351240,0.0,73760.0,425000,936640,0,196693,1133333,468320,0.0,98346.5,566666
928200,767108,0,161092,928200,383554,0.0,80546.0,464100,842976,0,177024,1020000,421488,0.0,88512.0,510000
296238,244824,0,51414,296238,122412,0.0,25707.0,148119,313878,0,65914,379792,156939,0.0,32957.0,189896
1570002,1297521,272481,0,1570002,648760,136240.5,0.0,785001,1730028,363308,0,2093336,865014,181654.0,0.0,1046668
1370000,1132232,0,237768,1370000,566116,0.0,118884.0,685000,1509643,0,317024,1826667,754821,0.0,158512.0,913334
550000,454546,0,95454,550000,227273,0.0,47727.0,275000,606061,0,127272,733333,303030,0.0,63636.0,366666
758000,626446,0,131554,758000,313223,0.0,65777.0,379000,835261,0,175406,1010667,417630,0.0,87703.0,505334
1400000,1157025,0,242975,1400000,578512,0.0,121487.5,700000,1542700,0,323967,1866667,771350,0.0,161983.5,933334
790000,652892,0,137108,790000,326446,0.0,68554.0,395000,870523,0,182810,1053333,435261,0.0,91405.0,526666
754887,623873,0,131014,754887,311936,0.0,65507.0,377444,659319,0,138457,797776,329659,0.0,69228.5,398888
1248000,1031404,0,216596,1248000,515702,0.0,108298.0,624000,1375205,0,288795,1664000,687602,0.0,144397.5,832000
922501,762398,0,160103,922501,381199,0.0,80051.5,461250,851119,0,178735,1029854,425559,0.0,89367.5,514927
595000,491735,0,103265,595000,245867,0.0,51632.5,297500,578512,0,121488,700000,289256,0.0,60744.0,350000
620000,512396,0,107604,620000,256198,0.0,53802.0,310000,683195,0,143472,826667,341597,0.0,71736.0,413334
720000,595042,0,124958,720000,297521,0.0,62479.0,360000,793389,0,166611,960000,396694,0.0,83305.5,480000
399998,330576,0,69422,399998,165288,0.0,34711.0,199999,440768,0,92563,533331,220384,0.0,46281.5,266666
193731,160108,0,33623,193731,80054,0.0,16811.5,96866,235454,0,49445,284899,117727,0.0,24722.5,142450
380470,314438,0,66032,380470,157219,0.0,33016.0,190235,419251,0,88042,507293,209625,0.0,44021.0,253646
346585,286434,0,60151,346585,143217,0.0,30075.5,173292,454658,0,95478,550136,227329,0.0,47739.0,275068
520470,430140,0,90330,520470,215070,0.0,45165.0,260235,544482,0,114342,658824,272241,0.0,57171.0,329412
541500,447520,0,93980,541500,223760,0.0,46990.0,270750,471074,0,98926,570000,235537,0.0,49463.0,285000
348557,288064,0,60493,348557,144032,0.0,30246.5,174278,423623,0,88961,512584,211811,0.0,44480.5,256292
319501,264050,0,55451,319501,132025,0.0,27725.5,159750,338526,0,71090,409616,169263,0.0,35545.0,204808
998000,824794,0,173206,998000,412397,0.0,86603.0,499000,1099725,0,230942,1330667,549862,0.0,115471.0,665334
827000,683471,0,143529,827000,341735,0.0,71764.5,413500,911295,0,191372,1102667,455647,0.0,95686.0,551334
282548,233511,0,49037,282548,116755,0.0,24518.5,141274,299372,0,62869,362241,149686,0.0,31434.5,181120
700000,578513,0,121487,700000,289256,0.0,60743.5,350000,771351,0,161982,933333,385675,0.0,80991.0,466666
488040,403339,0,84701,488040,201669,0.0,42350.5,244020,517101,0,108591,625692,258550,0.0,54295.5,312846
635000,524793,0,110207,635000,262396,0.0,55103.5,317500,699724,0,146943,846667,349862,0.0,73471.5,423334
287817,237865,0,49952,287817,118932,0.0,24976.0,143908,304956,0,64041,368997,152478,0.0,32020.5,184498
1610781,1331224,0,279557,1610781,665612,0.0,139778.5,805390,1823594,0,382955,2206549,911797,0.0,191477.5,1103274
796000,657852,0,138148,796000,328926,0.0,69074.0,398000,877136,0,184197,1061333,438568,0.0,92098.5,530666
139998,115700,0,24298,139998,57850,0.0,12149.0,69999,154267,0,32397,186664,77133,0.0,16198.5,93332
293360,242446,0,50914,293360,121223,0.0,25457.0,146680,310828,0,65274,376102,155414,0.0,32637.0,188051
598026,494236,0,103790,598026,247118,0.0,51895.0,299013,581454,0,122106,703560,290727,0.0,61053.0,351780
552330,456471,0,95859,552330,228235,0.0,47929.5,276165,724558,0,152157,876715,362279,0.0,76078.5,438358
299851,247811,0,52040,299851,123905,0.0,26020.0,149926,317705,0,66719,384424,158852,0.0,33359.5,192212
910100,752148,0,157952,910100,376074,0.0,78976.0,455050,791736,0,166264,958000,395868,0.0,83132.0,479000
2116000,1748760,0,367240,2116000,874380,0.0,183620.0,1058000,2331680,0,489653,2821333,1165840,0.0,244826.5,1410666
1020000,842975,0,177025,1020000,421487,0.0,88512.5,510000,1123967,0,236033,1360000,561983,0.0,118016.5,680000
1890000,1561983,0,328017,1890000,780991,0.0,164008.5,945000,2082644,0,437356,2520000,1041322,0.0,218678.0,1260000
600000,495868,0,104132,600000,247934,0.0,52066.0,300000,661157,0,138843,800000,330578,0.0,69421.5,400000
1740296,1438261,0,302035,1740296,719130,0.0,151017.5,870148,1917681,0,402714,2320395,958840,0.0,201357.0,1160198
1205738,996477,0,209261,1205738,498238,0.0,104630.5,602869,1756605,0,0,1756605,878302,0.0,0.0,878302
770000,636364,0,133636,770000,318182,0.0,66818.0,385000,848485,0,178182,1026667,424242,0.0,89091.0,513334
290155,239797,0,50358,290155,119898,0.0,25179.0,145078,380630,0,79932,460562,190315,0.0,39966.0,230281
1675000,1384298,0,290702,1675000,692149,0.0,145351.0,837500,1845731,0,387602,2233333,922865,0.0,193801.0,1116666
600000,495868,0,104132,600000,247934,0.0,52066.0,300000,661157,0,138843,800000,330578,0.0,69421.5,400000
1078000,890910,0,187090,1078000,445455,0.0,93545.0,539000,1272728,0,267272,1540000,636364,0.0,133636.0,770000
750000,619835,0,130165,750000,309917,0.0,65082.5,375000,826447,0,173553,1000000,413223,0.0,86776.5,500000
385466,318567,0,66899,385466,159283,0.0,33449.5,192733,408420,0,85768,494188,204210,0.0,42884.0,247094
880000,727272,0,152728,880000,363636,0.0,76364.0,440000,969696,0,203637,1173333,484848,0.0,101818.5,586666
700000,578512,0,121488,700000,289256,0.0,60744.0,350000,771349,0,161984,933333,385674,0.0,80992.0,466666
1180000,975206,0,204794,1180000,487603,0.0,102397.0,590000,1300275,0,273058,1573333,650137,0.0,136529.0,786666
1378048,1138883,0,239165,1378048,569441,0.0,119582.5,689024,1518511,0,318886,1837397,759255,0.0,159443.0,918698
1144580,945934,0,198646,1144580,472967,0.0,99323.0,572290,1261245,0,264862,1526107,630622,0.0,132431.0,763054
705884,583376,0,122508,705884,291688,0.0,61254.0,352942,777835,0,163344,941179,388917,0.0,81672.0,470590
600000,495868,0,104132,600000,247934,0.0,52066.0,300000,661157,0,138843,800000,330578,0.0,69421.5,400000
1080000,892562,0,187438,1080000,446281,0.0,93719.0,540000,1190083,0,249917,1440000,595041,0.0,124958.5,720000
900000,743802,0,156198,900000,371901,0.0,78099.0,450000,991736,0,208264,1200000,495868,0.0,104132.0,600000
470446,388798,0,81648,470446,194399,0.0,40824.0,235223,617140,0,129599,746739,308570,0.0,64799.5,373370
290155,239797,0,50358,290155,119898,0.0,25179.0,145078,380630,0,79932,460562,190315,0.0,39966.0,230281
559998,462808,0,97190,559998,231404,0.0,48595.0,279999,617077,0,129587,746664,308538,0.0,64793.5,373332
635098,524874,0,110224,635098,262437,0.0,55112.0,317549,672917,0,141312,814229,336458,0.0,70656.0,407114
714750,590703,0,124047,714750,295351,0.0,62023.5,357375,787604,0,165396,953000,393802,0.0,82698.0,476500
1360000,1123966,0,236034,1360000,561983,0.0,118017.0,680000,1498621,0,314712,1813333,749310,0.0,157356.0,906666
2242000,1852892,0,389108,2242000,926446,0.0,194554.0,1121000,2470523,0,518810,2989333,1235261,0.0,259405.0,1494666
2048057,1692609,355448,0,2048057,846304,177724.0,0.0,1024028,1886494,355448,0,2241942,943247,177724.0,0.0,1120971
2100000,1735537,0,364463,2100000,867768,0.0,182231.5,1050000,2314049,0,485951,2800000,1157024,0.0,242975.5,1400000
2092176,1729071,363105,0,2092176,864535,181552.5,0.0,1046088,1987438,363105,0,2350543,993719,181552.5,0.0,1175272
2534003,2094217,439786,0,2534003,1047108,219893.0,0.0,1267002,2792289,586381,0,3378670,1396144,293190.5,0.0,1689335
4410000,3644628,0,765372,4410000,1822314,0.0,382686.0,2205000,4859504,0,1020496,5880000,2429752,0.0,510248.0,2940000
2092176,1729071,363105,0,2092176,864535,181552.5,0.0,1046088,1987438,363105,0,2350543,993719,181552.5,0.0,1175272
2046888,1691643,0,355245,2046888,845821,0.0,177622.5,1023444,2255524,0,473660,2729184,1127762,0.0,236830.0,1364592
2046888,1691643,0,355245,2046888,845821,0.0,177622.5,1023444,2255524,0,473660,2729184,1127762,0.0,236830.0,1364592
2006000,1657852,0,348148,2006000,828926,0.0,174074.0,1003000,1950413,0,409587,2360000,975206,0.0,204793.5,1180000
3186400,2633388,0,553012,3186400,1316694,0.0,276506.0,1593200,3511184,0,737349,4248533,1755592,0.0,368674.5,2124266
1550000,1280991,0,269009,1550000,640495,0.0,134504.5,775000,1707988,0,358679,2066667,853994,0.0,179339.5,1033334
1200000,991735,0,208265,1200000,495867,0.0,104132.5,600000,1322313,0,277687,1600000,661156,0.0,138843.5,800000
1016000,839670,0,176330,1016000,419835,0.0,88165.0,508000,1119560,0,235107,1354667,559780,0.0,117553.5,677334
367435,303666,0,63769,367435,151833,0.0,31884.5,183718,446566,0,93779,540345,223283,0.0,46889.5,270172
1532155,1266243,0,265912,1532155,633121,0.0,132956.0,766078,2231821,0,0,2231821,1115910,0.0,0.0,1115910
1044700,863389,0,181311,1044700,431694,0.0,90655.5,522350,1151185,0,241748,1392933,575592,0.0,120874.0,696466
582418,481337,0,101081,582418,240668,0.0,50540.5,291209,617099,0,129591,746690,308549,0.0,64795.5,373345
700000,578512,0,121488,700000,289256,0.0,60744.0,350000,771349,0,161984,933333,385674,0.0,80992.0,466666
1550000,1280992,0,269008,1550000,640496,0.0,134504.0,775000,1707989,0,358678,2066667,853994,0.0,179339.0,1033334
635693,525366,0,110327,635693,262683,0.0,55163.5,317846,673546,0,141444,814990,336773,0.0,70722.0,407495
1050000,867768,0,182232,1050000,433884,0.0,91116.0,525000,1157024,0,242976,1400000,578512,0.0,121488.0,700000
992500,820248,0,172252,992500,410124,0.0,86126.0,496250,1093664,0,229669,1323333,546832,0.0,114834.5,661666
1566266,1294435,0,271831,1566266,647217,0.0,135915.5,783133,1725913,0,362442,2088355,862956,0.0,181221.0,1044178
180000,148760,0,31240,180000,74380,0.0,15620.0,90000,198347,0,41653,240000,99173,0.0,20826.5,120000
600000,495868,0,104132,600000,247934,0.0,52066.0,300000,661157,0,138843,800000,330578,0.0,69421.5,400000
345117,285221,0,59896,345117,142610,0.0,29948.0,172558,365667,0,76790,442457,182833,0.0,38395.0,221228
1091166,901790,0,189376,1091166,450895,0.0,94688.0,545583,1156141,0,242790,1398931,578070,0.0,121395.0,699466
650000,537190,0,112810,650000,268595,0.0,56405.0,325000,716253,0,150414,866667,358126,0.0,75207.0,433334
1100000,909090,0,190910,1100000,454545,0.0,95455.0,550000,1212120,0,254547,1466667,606060,0.0,127273.5,733334
700000,578512,0,121488,700000,289256,0.0,60744.0,350000,771349,0,161984,933333,385674,0.0,80992.0,466666
418000,345454,0,72546,418000,172727,0.0,36273.0,209000,460605,0,96728,557333,230302,0.0,48364.0,278666
582418,481337,0,101081,582418,240668,0.0,50540.5,291209,617099,0,129591,746690,308549,0.0,64795.5,373345
483000,399174,0,83826,483000,199587,0.0,41913.0,241500,532232,0,111768,644000,266116,0.0,55884.0,322000
400000,330578,0,69422,400000,165289,0.0,34711.0,200000,440771,0,92562,533333,220385,0.0,46281.0,266666
1000000,826446,0,173554,1000000,413223,0.0,86777.0,500000,1101928,0,231405,1333333,550964,0.0,115702.5,666666
900000,743802,0,156198,900000,371901,0.0,78099.0,450000,991736,0,208264,1200000,495868,0.0,104132.0,600000
674112,552098,0,122014,674112,276049,0.0,61007.0,337056,920164,0,203356,1123520,460082,0.0,101678.0,561760
575434,471281,0,104153,575434,235640,0.0,52076.5,287717,785470,0,173588,959058,392735,0.0,86794.0,479529
339998,280990,0,59008,339998,140495,0.0,29504.0,169999,374653,0,78678,453331,187326,0.0,39339.0,226666
4058999,3354545,0,704454,4058999,1677272,0.0,352227.0,2029500,3570248,0,749751,4319999,1785124,0.0,374875.5,2160000
2606745,2154335,0,452410,2606745,1077167,0.0,226205.0,1303372,2872447,0,603213,3475660,1436223,0.0,301606.5,1737830
3211110,2653810,0,557300,3211110,1326905,0.0,278650.0,1605555,3538413,0,743067,4281480,1769206,0.0,371533.5,2140740
3329800,2751901,0,577899,3329800,1375950,0.0,288949.5,1664900,3669201,0,770532,4439733,1834600,0.0,385266.0,2219866
1594500,1317769,0,276731,1594500,658884,0.0,138365.5,797250,1365289,0,286711,1652000,682644,0.0,143355.5,826000
1157897,956940,0,200957,1157897,478470,0.0,100478.5,578948,1275920,0,267943,1543863,637960,0.0,133971.5,771932
10666666,8815426,0,1851240,10666666,4407713,0.0,925620.0,5333333,11019283,0,2314050,13333333,5509641,0.0,1157025.0,6666666
421619,348446,0,73173,421619,174223,0.0,36586.5,210810,446725,0,93812,540537,223362,0.0,46906.0,270268
1910000,1578513,0,331487,1910000,789256,0.0,165743.5,955000,2104684,0,441983,2546667,1052342,0.0,220991.5,1273334
1589200,1313389,0,275811,1589200,656694,0.0,137905.5,794600,1751185,0,367748,2118933,875592,0.0,183874.0,1059466
2789492,2305366,0,484126,2789492,1152683,0.0,242063.0,1394746,3073821,0,645502,3719323,1536910,0.0,322751.0,1859662
2350000,1942148,0,407852,2350000,971074,0.0,203926.0,1175000,2589531,0,543802,3133333,1294765,0.0,271901.0,1566666
2800000,2314049,0,485951,2800000,1157024,0.0,242975.5,1400000,3085399,0,647934,3733333,1542699,0.0,323967.0,1866666
1231110,1017446,0,213664,1231110,508723,0.0,106832.0,615555,1356595,0,284885,1641480,678297,0.0,142442.5,820740
2319000,1916529,0,402471,2319000,958264,0.0,201235.5,1159500,2555372,0,536628,3092000,1277686,0.0,268314.0,1546000
1241532,1026058,215474,0,1241532,513029,107737.0,0.0,620766,1148197,215474,0,1363671,574098,107737.0,0.0,681836
1900000,1570248,0,329752,1900000,785124,0.0,164876.0,950000,2093664,0,439669,2533333,1046832,0.0,219834.5,1266666
1800000,1487603,0,312397,1800000,743801,0.0,156198.5,900000,1983471,0,416529,2400000,991735,0.0,208264.5,1200000
1370000,1132232,0,237768,1370000,566116,0.0,118884.0,685000,1509643,0,317024,1826667,754821,0.0,158512.0,913334
863000,713223,0,149777,863000,356611,0.0,74888.5,431500,950964,0,199703,1150667,475482,0.0,99851.5,575334
960000,793389,0,166611,960000,396694,0.0,83305.5,480000,1057852,0,222148,1280000,528926,0.0,111074.0,640000
1249000,1032232,0,216768,1249000,516116,0.0,108384.0,624500,1376309,0,289024,1665333,688154,0.0,144512.0,832666
1265000,1045455,0,219545,1265000,522727,0.0,109772.5,632500,1393940,0,292727,1686667,696970,0.0,146363.5,843334
870000,719008,0,150992,870000,359504,0.0,75496.0,435000,958677,0,201323,1160000,479338,0.0,100661.5,580000
750000,619834,0,130166,750000,309917,0.0,65083.0,375000,826445,0,173555,1000000,413222,0.0,86777.5,500000
430000,355372,0,74628,430000,177686,0.0,37314.0,215000,473829,0,99504,573333,236914,0.0,49752.0,286666
306499,253305,0,53194,306499,126652,0.0,26597.0,153250,324750,0,68198,392948,162375,0.0,34099.0,196474
700000,578512,0,121488,700000,289256,0.0,60744.0,350000,771349,0,161984,933333,385674,0.0,80992.0,466666
666000,550413,0,115587,666000,275206,0.0,57793.5,333000,688016,0,144484,832500,344008,0.0,72242.0,416250
631746,517400,0,114346,631746,258700,0.0,57173.0,315873,1055918,0,233358,1289276,527959,0.0,116679.0,644638
579800,479174,0,100626,579800,239587,0.0,50313.0,289900,638899,0,134168,773067,319449,0.0,67084.0,386534
633015,523153,0,109862,633015,261576,0.0,54931.0,316508,871921,0,183104,1055025,435960,0.0,91552.0,527512
294119,243074,0,51045,294119,121537,0.0,25522.5,147060,291688,0,61254,352942,145844,0.0,30627.0,176471
610000,504132,0,105868,610000,252066,0.0,52934.0,305000,672176,0,141157,813333,336088,0.0,70578.5,406666
700000,578513,0,121487,700000,289256,0.0,60743.5,350000,771351,0,161982,933333,385675,0.0,80991.0,466666
341227,282006,0,59221,341227,141003,0.0,29610.5,170614,414714,0,87090,501804,207357,0.0,43545.0,250902
670000,553719,0,116281,670000,276859,0.0,58140.5,335000,738292,0,155041,893333,369146,0.0,77520.5,446666
360000,297520,0,62480,360000,148760,0.0,31240.0,180000,396693,0,83307,480000,198346,0.0,41653.5,240000
315989,261148,0,54841,315989,130574,0.0,27420.5,157994,414520,0,87049,501569,207260,0.0,43524.5,250784
221467,183031,0,38436,221467,91515,0.0,19218.0,110734,290524,0,61010,351534,145262,0.0,30505.0,175767
620000,512397,0,107603,620000,256198,0.0,53801.5,310000,683196,0,143471,826667,341598,0.0,71735.5,413334
290000,239670,0,50330,290000,119835,0.0,25165.0,145000,319560,0,67107,386667,159780,0.0,33553.5,193334
544216,449765,0,94451,544216,224882,0.0,47225.5,272108,661419,0,138899,800318,330709,0.0,69449.5,400159
1100000,909090,0,190910,1100000,454545,0.0,95455.0,550000,1212120,0,254547,1466667,606060,0.0,127273.5,733334
308870,255265,0,53605,308870,127632,0.0,26802.5,154435,405181,0,85088,490269,202590,0.0,42544.0,245134
261348,215990,0,45358,261348,107995,0.0,22679.0,130674,342840,0,71997,414837,171420,0.0,35998.5,207418
239052,197564,0,41488,239052,98782,0.0,20744.0,119526,253286,0,53190,306476,126643,0.0,26595.0,153238
610000,504132,0,105868,610000,252066,0.0,52934.0,305000,672176,0,141157,813333,336088,0.0,70578.5,406666
1080001,892562,187439,0,1080001,446281,93719.5,0.0,540000,991735,187439,0,1179174,495867,93719.5,0.0,589587
315700,260909,0,54791,315700,130454,0.0,27395.5,157850,334499,0,70245,404744,167249,0.0,35122.5,202372
270000,223140,0,46860,270000,111570,0.0,23430.0,135000,297520,0,62480,360000,148760,0.0,31240.0,180000
117340,96975,0,20365,117340,48487,0.0,10182.5,58670,124327,0,26108,150435,62163,0.0,13054.0,75218
366786,303129,0,63657,366786,151564,0.0,31828.5,183393,388628,0,81611,470239,194314,0.0,40805.5,235120
2449000,2023967,0,425033,2449000,1011983,0.0,212516.5,1224500,2698623,0,566710,3265333,1349311,0.0,283355.0,1632666
6744845,5574252,0,1170593,6744845,2787126,0.0,585296.5,3372422,7432336,0,1560791,8993127,3716168,0.0,780395.5,4496564
3163000,2614050,0,548950,3163000,1307025,0.0,274475.0,1581500,3485400,0,731933,4217333,1742700,0.0,365966.5,2108666
5398800,4461818,0,936982,5398800,2230909,0.0,468491.0,2699400,5949091,0,1249309,7198400,2974545,0.0,624654.5,3599200
5800000,4793388,0,1006612,5800000,2396694,0.0,503306.0,2900000,6391184,0,1342149,7733333,3195592,0.0,671074.5,3866666
6184297,5110989,0,1073308,6184297,2555494,0.0,536654.0,3092148,6814652,0,1431077,8245729,3407326,0.0,715538.5,4122864
2217997,1833056,384941,0,2217997,916528,192470.5,0.0,1108998,2444075,513255,0,2957330,1222037,256627.5,0.0,1478665
2449000,2023967,0,425033,2449000,1011983,0.0,212516.5,1224500,2698623,0,566710,3265333,1349311,0.0,283355.0,1632666
3448000,2849587,0,598413,3448000,1424793,0.0,299206.5,1724000,3799449,0,797884,4597333,1899724,0.0,398942.0,2298666
1900000,1570247,0,329753,1900000,785123,0.0,164876.5,950000,2093663,0,439670,2533333,1046831,0.0,219835.0,1266666
2019000,1668595,0,350405,2019000,834297,0.0,175202.5,1009500,2224793,0,467207,2692000,1112396,0.0,233603.5,1346000
8593750,7102273,0,1491477,8593750,3551136,0.0,745738.5,4296875,9469697,0,1988636,11458333,4734848,0.0,994318.0,5729166
2156000,1781818,0,374182,2156000,890909,0.0,187091.0,1078000,3239669,0,680331,3920000,1619834,0.0,340165.5,1960000
1770000,1462810,0,307190,1770000,731405,0.0,153595.0,885000,1950413,0,409587,2360000,975206,0.0,204793.5,1180000
1950000,1611570,0,338430,1950000,805785,0.0,169215.0,975000,2148760,0,451240,2600000,1074380,0.0,225620.0,1300000
3000000,2479339,0,520661,3000000,1239669,0.0,260330.5,1500000,3305785,0,694215,4000000,1652892,0.0,347107.5,2000000
2050000,1694215,0,355785,2050000,847107,0.0,177892.5,1025000,2258953,0,474380,2733333,1129476,0.0,237190.0,1366666
1426700,1179091,0,247609,1426700,589545,0.0,123804.5,713350,1572121,0,330146,1902267,786060,0.0,165073.0,951134
6787200,5609256,0,1177944,6787200,2804628,0.0,588972.0,3393600,7011570,0,1472430,8484000,3505785,0.0,736215.0,4242000
2790000,2305785,0,484215,2790000,1152892,0.0,242107.5,1395000,2975207,0,624793,3600000,1487603,0.0,312396.5,1800000
2008500,1659918,0,348582,2008500,829959,0.0,174291.0,1004250,2213224,0,464776,2678000,1106612,0.0,232388.0,1339000
1825000,1508265,0,316735,1825000,754132,0.0,158367.5,912500,2011020,0,422313,2433333,1005510,0.0,211156.5,1216666
1485000,1227273,0,257727,1485000,613636,0.0,128863.5,742500,1636364,0,343636,1980000,818182,0.0,171818.0,990000
1548000,1279339,0,268661,1548000,639669,0.0,134330.5,774000,1705785,0,358215,2064000,852892,0.0,179107.5,1032000
1650000,1363636,0,286364,1650000,681818,0.0,143182.0,825000,1818181,0,381819,2200000,909090,0.0,190909.5,1100000
2070000,1710744,0,359256,2070000,855372,0.0,179628.0,1035000,2280992,0,479008,2760000,1140496,0.0,239504.0,1380000
1120000,925620,0,194380,1120000,462810,0.0,97190.0,560000,1234160,0,259173,1493333,617080,0.0,129586.5,746666
8260000,6826446,0,1433554,8260000,3413223,0.0,716777.0,4130000,9101928,0,1911405,11013333,4550964,0.0,955702.5,5506666
1273784,1052714,0,221070,1273784,526357,0.0,110535.0,636892,1403619,0,294760,1698379,701809,0.0,147380.0,849190
1176000,971900,0,204100,1176000,485950,0.0,102050.0,588000,1295867,0,272133,1568000,647933,0.0,136066.5,784000
1928000,1593388,0,334612,1928000,796694,0.0,167306.0,964000,2124517,0,446150,2570667,1062258,0.0,223075.0,1285334
2826088,2335610,0,490478,2826088,1167805,0.0,245239.0,1413044,3114147,0,653970,3768117,1557073,0.0,326985.0,1884058
575000,475207,0,99793,575000,237603,0.0,49896.5,287500,633609,0,133058,766667,316804,0.0,66529.0,383334
55888000,46188430,0,9699570,55888000,23094215,0.0,4849785.0,27944000,61584573,0,12932760,74517333,30792286,0.0,6466380.0,37258666
5300000,4380165,0,919835,5300000,2190082,0.0,459917.5,2650000,5840220,0,1226447,7066667,2920110,0.0,613223.5,3533334
1360000,1123967,0,236033,1360000,561983,0.0,118016.5,680000,1322314,0,277686,1600000,661157,0.0,138843.0,800000
4060000,3355372,0,704628,4060000,1677686,0.0,352314.0,2030000,4473829,0,939504,5413333,2236914,0.0,469752.0,2706666
5400000,4462810,0,937190,5400000,2231405,0.0,468595.0,2700000,5950413,0,1249587,7200000,2975206,0.0,624793.5,3600000
2020000,1669422,0,350578,2020000,834711,0.0,175289.0,1010000,2225896,0,467437,2693333,1112948,0.0,233718.5,1346666
2424483,2003705,0,420778,2424483,1001852,0.0,210389.0,1212242,2671607,0,561037,3232644,1335803,0.0,280518.5,1616322
3924375,3243285,0,681090,3924375,1621642,0.0,340545.0,1962188,6486570,0,1362180,7848750,3243285,0.0,681090.0,3924375
3924375,3243285,0,681090,3924375,1621642,0.0,340545.0,1962188,6486570,0,1362180,7848750,3243285,0.0,681090.0,3924375
2898000,2395042,0,502958,2898000,1197521,0.0,251479.0,1449000,3193389,0,670611,3864000,1596694,0.0,335305.5,1932000
2365200,1954711,0,410489,2365200,977355,0.0,205244.5,1182600,2606281,0,547319,3153600,1303140,0.0,273659.5,1576800
2898000,2395042,0,502958,2898000,1197521,0.0,251479.0,1449000,3193389,0,670611,3864000,1596694,0.0,335305.5,1932000
3080000,2545454,0,534546,3080000,1272727,0.0,267273.0,1540000,3636363,0,763637,4400000,1818181,0.0,381818.5,2200000
2500000,2066116,0,433884,2500000,1033058,0.0,216942.0,1250000,2754821,0,578512,3333333,1377410,0.0,289256.0,1666666
2175528,1797957,0,377571,2175528,898978,0.0,188785.5,1087764,2568510,0,539387,3107897,1284255,0.0,269693.5,1553948
1360000,1123967,0,236033,1360000,561983,0.0,118016.5,680000,1322314,0,277686,1600000,661157,0.0,138843.0,800000
1358922,1123076,0,235846,1358922,561538,0.0,117923.0,679461,1979647,0,0,1979647,989823,0.0,0.0,989824
1858000,1535537,0,322463,1858000,767768,0.0,161231.5,929000,2047383,0,429950,2477333,1023691,0.0,214975.0,1238666
876000,723967,0,152033,876000,361983,0.0,76016.5,438000,965289,0,202711,1168000,482644,0.0,101355.5,584000
2201578,1819486,0,382092,2201578,909743,0.0,191046.0,1100789,2425981,0,509456,2935437,1212990,0.0,254728.0,1467718
938900,775950,0,162950,938900,387975,0.0,81475.0,469450,1034600,0,217267,1251867,517300,0.0,108633.5,625934
1900000,1570248,0,329752,1900000,785124,0.0,164876.0,950000,2093664,0,439669,2533333,1046832,0.0,219834.5,1266666
1359000,1123140,0,235860,1359000,561570,0.0,117930.0,679500,1497520,0,314480,1812000,748760,0.0,157240.0,906000
2040000,1685950,0,354050,2040000,842975,0.0,177025.0,1020000,1983471,0,416529,2400000,991735,0.0,208264.5,1200000
3820000,3157025,0,662975,3820000,1578512,0.0,331487.5,1910000,3661157,0,768843,4430000,1830578,0.0,384421.5,2215000
8800000,7272727,0,1527273,8800000,3636363,0.0,763636.5,4400000,9696969,0,2036364,11733333,4848484,0.0,1018182.0,5866666
5288750,4370868,0,917882,5288750,2185434,0.0,458941.0,2644375,5827824,0,1223843,7051667,2913912,0.0,611921.5,3525834
3660252,3025000,635252,0,3660252,1512500,317626.0,0.0,1830126,4033333,847003,0,4880336,2016666,423501.5,0.0,2440168
5432900,4490000,942900,0,5432900,2245000,471450.0,0.0,2716450,5986667,1257200,0,7243867,2993333,628600.0,0.0,3621934
3660252,3025000,635252,0,3660252,1512500,317626.0,0.0,1830126,4033333,847003,0,4880336,2016666,423501.5,0.0,2440168
7153024,5911591,0,1241433,7153024,2955795,0.0,620716.5,3576512,7882121,0,1655244,9537365,3941060,0.0,827622.0,4768682
6030000,4983471,0,1046529,6030000,2491735,0.0,523264.5,3015000,6644628,0,1395372,8040000,3322314,0.0,697686.0,4020000
4293000,3547934,0,745066,4293000,1773967,0.0,372533.0,2146500,4730579,0,993421,5724000,2365289,0.0,496710.5,2862000
2400000,1983471,0,416529,2400000,991735,0.0,208264.5,1200000,2644628,0,555372,3200000,1322314,0.0,277686.0,1600000
5515796,4558510,957286,0,5515796,2279255,478643.0,0.0,2757898,6078013,1276381,0,7354394,3039006,638190.5,0.0,3677197
2179998,1801652,0,378346,2179998,900826,0.0,189173.0,1089999,2402203,0,504461,2906664,1201101,0.0,252230.5,1453332
9780000,8082645,0,1697355,9780000,4041322,0.0,848677.5,4890000,10776860,0,2263140,13040000,5388430,0.0,1131570.0,6520000
3896549,3220289,0,676260,3896549,1610144,0.0,338130.0,1948274,4293719,0,901680,5195399,2146859,0.0,450840.0,2597700
5030000,4157025,0,872975,5030000,2078512,0.0,436487.5,2515000,5542700,0,1163967,6706667,2771350,0.0,581983.5,3353334
3849999,3181817,0,668182,3849999,1590908,0.0,334091.0,1925000,4242423,0,890909,5133332,2121211,0.0,445454.5,2566666
6348000,5246281,0,1101719,6348000,2623140,0.0,550859.5,3174000,6995041,0,1468959,8464000,3497520,0.0,734479.5,4232000
2379998,1966941,0,413057,2379998,983470,0.0,206528.5,1189999,2622588,0,550743,3173331,1311294,0.0,275371.5,1586666
2800000,2314049,0,485951,2800000,1157024,0.0,242975.5,1400000,3085399,0,647934,3733333,1542699,0.0,323967.0,1866666
8307692,6865861,0,1441831,8307692,3432930,0.0,720915.5,4153846,9154481,0,1922442,11076923,4577240,0.0,961221.0,5538462
3000000,2479338,0,520662,3000000,1239669,0.0,260331.0,1500000,3305784,0,694216,4000000,1652892,0.0,347108.0,2000000
2636666,2179063,0,457603,2636666,1089531,0.0,228801.5,1318333,2497703,0,524518,3022221,1248851,0.0,262259.0,1511110
4000000,3305785,0,694215,4000000,1652892,0.0,347107.5,2000000,4407713,0,925620,5333333,2203856,0.0,462810.0,2666666
6030000,4983471,0,1046529,6030000,2491735,0.0,523264.5,3015000,6644628,0,1395372,8040000,3322314,0.0,697686.0,4020000
2996000,2476033,0,519967,2996000,1238016,0.0,259983.5,1498000,3301377,0,693290,3994667,1650688,0.0,346645.0,1997334
2184000,1804958,0,379042,2184000,902479,0.0,189521.0,1092000,2406611,0,505389,2912000,1203305,0.0,252694.5,1456000
2400000,1983471,0,416529,2400000,991735,0.0,208264.5,1200000,2644628,0,555372,3200000,1322314,0.0,277686.0,1600000
3182400,2630083,0,552317,3182400,1315041,0.0,276158.5,1591200,3506777,0,736423,4243200,1753388,0.0,368211.5,2121600
2379000,1966116,0,412884,2379000,983058,0.0,206442.0,1189500,2621488,0,550512,3172000,1310744,0.0,275256.0,1586000
2928000,2419835,0,508165,2928000,1209917,0.0,254082.5,1464000,5041322,0,1058678,6100000,2520661,0.0,529339.0,3050000
2825000,2334711,0,490289,2825000,1167355,0.0,245144.5,1412500,3112948,0,653719,3766667,1556474,0.0,326859.5,1883334
2784088,2300899,0,483189,2784088,1150449,0.0,241594.5,1392044,2876124,0,603986,3480110,1438062,0.0,301993.0,1740055
5000000,4132232,0,867768,5000000,2066116,0.0,433884.0,2500000,5509643,0,1157024,6666667,2754821,0.0,578512.0,3333334
8574900,7086694,0,1488206,8574900,3543347,0.0,744103.0,4287450,9448925,0,1984275,11433200,4724462,0.0,992137.5,5716600
3246318,2682908,0,563410,3246318,1341454,0.0,281705.0,1623159,3577211,0,751213,4328424,1788605,0.0,375606.5,2164212
7300000,6033058,0,1266942,7300000,3016529,0.0,633471.0,3650000,8044077,0,1689256,9733333,4022038,0.0,844628.0,4866666
11900000,9834711,0,2065289,11900000,4917355,0.0,1032644.5,5950000,13112948,0,2753719,15866667,6556474,0.0,1376859.5,7933334
2752349,2274669,0,477680,2752349,1137334,0.0,238840.0,1376174,3032892,0,636907,3669799,1516446,0.0,318453.5,1834900
3169778,2619651,0,550127,3169778,1309825,0.0,275063.5,1584889,5953752,0,1250288,7204040,2976876,0.0,625144.0,3602020
3930191,3248091,0,682100,3930191,1624045,0.0,341050.0,1965096,4958881,0,1041365,6000246,2479440,0.0,520682.5,3000123
3002200,2481157,0,521043,3002200,1240578,0.0,260521.5,1501100,2919008,0,612992,3532000,1459504,0.0,306496.0,1766000
2460000,2033058,0,426942,2460000,1016529,0.0,213471.0,1230000,2710744,0,569256,3280000,1355372,0.0,284628.0,1640000
5600000,4628100,0,971900,5600000,2314050,0.0,485950.0,2800000,4958678,0,1041322,6000000,2479339,0.0,520661.0,3000000
3500000,2892562,0,607438,3500000,1446281,0.0,303719.0,1750000,3856749,0,809918,4666667,1928374,0.0,404959.0,2333334
1889999,1561983,0,328016,1889999,780991,0.0,164008.0,945000,2082644,0,437355,2519999,1041322,0.0,218677.5,1260000
2070179,1710891,0,359288,2070179,855445,0.0,179644.0,1035090,3015911,0,0,3015911,1507955,0.0,0.0,1507956
2000000,1652892,0,347108,2000000,826446,0.0,173554.0,1000000,2203856,0,462811,2666667,1101928,0.0,231405.5,1333334
6418888,5304867,0,1114021,6418888,2652433,0.0,557010.5,3209444,7073156,0,1485361,8558517,3536578,0.0,742680.5,4279258
2754000,2276033,0,477967,2754000,1138016,0.0,238983.5,1377000,3034711,0,637289,3672000,1517355,0.0,318644.5,1836000
1501000,1240496,0,260504,1501000,620248,0.0,130252.0,750500,1433884,0,301116,1735000,716942,0.0,150558.0,867500
2878740,2379124,499616,0,2878740,1189562,249808.0,0.0,1439370,3172165,666155,0,3838320,1586082,333077.5,0.0,1919160
2507120,2072000,0,435120,2507120,1036000,0.0,217560.0,1253560,2762667,0,580160,3342827,1381333,0.0,290080.0,1671414
3379999,2793387,0,586612,3379999,1396693,0.0,293306.0,1690000,3724516,0,782149,4506665,1862258,0.0,391074.5,2253332
1524400,1259834,0,264566,1524400,629917,0.0,132283.0,762200,1574794,0,330706,1905500,787397,0.0,165353.0,952750
1109000,960173,0,148827,1109000,480086,0.0,74413.5,554500,1280231,0,198436,1478667,640115,0.0,99218.0,739334
1378000,1138843,0,239157,1378000,569421,0.0,119578.5,689000,1518457,0,318876,1837333,759228,0.0,159438.0,918666
1378000,1138843,0,239157,1378000,569421,0.0,119578.5,689000,1518457,0,318876,1837333,759228,0.0,159438.0,918666
4554000,3763636,0,790364,4554000,1881818,0.0,395182.0,2277000,5018181,0,1053819,6072000,2509090,0.0,526909.5,3036000
846153,699300,0,146853,846153,349650,0.0,73426.5,423076,932400,0,195804,1128204,466200,0.0,97902.0,564102
4000000,3305786,0,694214,4000000,1652893,0.0,347107.0,2000000,4407715,0,925618,5333333,2203857,0.0,462809.0,2666666
5600000,4628100,0,971900,5600000,2314050,0.0,485950.0,2800000,6611570,0,1388430,8000000,3305785,0.0,694215.0,4000000
4000000,3305786,0,694214,4000000,1652893,0.0,347107.0,2000000,4407715,0,925618,5333333,2203857,0.0,462809.0,2666666
2150000,1776860,0,373140,2150000,888430,0.0,186570.0,1075000,2369147,0,497520,2866667,1184573,0.0,248760.0,1433334
1652500,1365702,0,286798,1652500,682851,0.0,143399.0,826250,1508264,0,316736,1825000,754132,0.0,158368.0,912500
2850000,2355372,0,494628,2850000,1177686,0.0,247314.0,1425000,3140496,0,659504,3800000,1570248,0.0,329752.0,1900000
1180000,975206,0,204794,1180000,487603,0.0,102397.0,590000,1300275,0,273058,1573333,650137,0.0,136529.0,786666
2800000,2314050,0,485950,2800000,1157025,0.0,242975.0,1400000,3085400,0,647933,3733333,1542700,0.0,323966.5,1866666
846153,699300,0,146853,846153,349650,0.0,73426.5,423076,932400,0,195804,1128204,466200,0.0,97902.0,564102
1200000,991735,0,208265,1200000,495867,0.0,104132.5,600000,1322313,0,277687,1600000,661156,0.0,138843.5,800000
2100000,1735538,0,364462,2100000,867769,0.0,182231.0,1050000,5785124,0,1214876,7000000,2892562,0.0,607438.0,3500000
1100000,909090,0,190910,1100000,454545,0.0,95455.0,550000,1212120,0,254547,1466667,606060,0.0,127273.5,733334
2800000,2314050,0,485950,2800000,1157025,0.0,242975.0,1400000,3085400,0,647933,3733333,1542700,0.0,323966.5,1866666
1400000,1146602,0,253398,1400000,573301,0.0,126699.0,700000,1528803,0,337864,1866667,764401,0.0,168932.0,933334
750000,619835,0,130165,750000,309917,0.0,65082.5,375000,826447,0,173553,1000000,413223,0.0,86776.5,500000
790000,652892,0,137108,790000,326446,0.0,68554.0,395000,870523,0,182810,1053333,435261,0.0,91405.0,526666
14300000,11818181,0,2481819,14300000,5909090,0.0,1240909.5,7150000,15757575,0,3309092,19066667,7878787,0.0,1654546.0,9533334
280000,231404,0,48596,280000,115702,0.0,24298.0,140000,308539,0,64794,373333,154269,0.0,32397.0,186666
760938,628874,0,132064,760938,314437,0.0,66032.0,380469,838499,0,176085,1014584,419249,0.0,88042.5,507292
830000,685950,0,144050,830000,342975,0.0,72025.0,415000,914600,0,192067,1106667,457300,0.0,96033.5,553334
1000000,826446,0,173554,1000000,413223,0.0,86777.0,500000,1101928,0,231405,1333333,550964,0.0,115702.5,666666
2670000,2206612,0,463388,2670000,1103306,0.0,231694.0,1335000,2942149,0,617851,3560000,1471074,0.0,308925.5,1780000
705000,582644,0,122356,705000,291322,0.0,61178.0,352500,776859,0,163141,940000,388429,0.0,81570.5,470000
846000,699174,0,146826,846000,349587,0.0,73413.0,423000,932232,0,195768,1128000,466116,0.0,97884.0,564000
1972000,1629752,342248,0,1972000,814876,171124.0,0.0,986000,2247934,342248,0,2590182,1123967,171124.0,0.0,1295091
3666300,3030000,636300,0,3666300,1515000,318150.0,0.0,1833150,4040000,848400,0,4888400,2020000,424200.0,0.0,2444200
4179000,3453719,0,725281,4179000,1726859,0.0,362640.5,2089500,4462810,0,937190,5400000,2231405,0.0,468595.0,2700000
2903800,2399835,0,503965,2903800,1199917,0.0,251982.5,1451900,3199780,0,671953,3871733,1599890,0.0,335976.5,1935866
1970719,1628693,0,342026,1970719,814346,0.0,171013.0,985360,2870871,0,0,2870871,1435435,0.0,0.0,1435436
2903800,2399835,0,503965,2903800,1199917,0.0,251982.5,1451900,3199780,0,671953,3871733,1599890,0.0,335976.5,1935866
4387349,3625908,0,761441,4387349,1812954,0.0,380720.5,2193674,3790908,0,796091,4586999,1895454,0.0,398045.5,2293500
4658501,3850000,808501,0,4658501,1925000,404250.5,0.0,2329250,5133333,1078001,0,6211334,2566666,539000.5,0.0,3105667
580000,479339,0,100661,580000,239669,0.0,50330.5,290000,639119,0,134214,773333,319559,0.0,67107.0,386666
3630000,3000000,0,630000,3630000,1500000,0.0,315000.0,1815000,4000000,0,840000,4840000,2000000,0.0,420000.0,2420000
5376000,4442975,0,933025,5376000,2221487,0.0,466512.5,2688000,5923967,0,1244033,7168000,2961983,0.0,622016.5,3584000
1493080,1233950,0,259130,1493080,616975,0.0,129565.0,746540,1645267,0,345506,1990773,822633,0.0,172753.0,995386
5094100,4210000,884100,0,5094100,2105000,442050.0,0.0,2547050,5613333,1178800,0,6792133,2806666,589400.0,0.0,3396066
9500000,7851240,0,1648760,9500000,3925620,0.0,824380.0,4750000,10468320,0,2198347,12666667,5234160,0.0,1099173.5,6333334
3728000,3080991,0,647009,3728000,1540495,0.0,323504.5,1864000,4107988,0,862679,4970667,2053994,0.0,431339.5,2485334
1419998,1173552,0,246446,1419998,586776,0.0,123223.0,709999,1564736,0,328595,1893331,782368,0.0,164297.5,946666
1939234,1602673,0,336561,1939234,801336,0.0,168280.5,969617,2584955,0,542841,3127796,1292477,0.0,271420.5,1563898
1701153,1405912,0,295241,1701153,702956,0.0,147620.5,850576,2811822,0,590483,3402305,1405911,0.0,295241.5,1701152
1105409,913561,0,191848,1105409,456780,0.0,95924.0,552704,1233801,0,259099,1492900,616900,0.0,129549.5,746450
1340000,1107438,0,232562,1340000,553719,0.0,116281.0,670000,1476584,0,310083,1786667,738292,0.0,155041.5,893334
4225000,3491735,0,733265,4225000,1745867,0.0,366632.5,2112500,4655647,0,977686,5633333,2327823,0.0,488843.0,2816666
2654850,2194091,0,460759,2654850,1097045,0.0,230379.5,1327425,2925455,0,614345,3539800,1462727,0.0,307172.5,1769900
1855000,1533058,0,321942,1855000,766529,0.0,160971.0,927500,2044077,0,429256,2473333,1022038,0.0,214628.0,1236666
1548000,1279339,0,268661,1548000,639669,0.0,134330.5,774000,1705785,0,358215,2064000,852892,0.0,179107.5,1032000
2281650,1885661,0,395989,2281650,942830,0.0,197994.5,1140825,1944793,0,408407,2353200,972396,0.0,204203.5,1176600
2625000,2169422,0,455578,2625000,1084711,0.0,227789.0,1312500,2892563,0,607437,3500000,1446281,0.0,303718.5,1750000
1636000,1352066,0,283934,1636000,676033,0.0,141967.0,818000,1802755,0,378578,2181333,901377,0.0,189289.0,1090666
1101600,910413,0,191187,1101600,455206,0.0,95593.5,550800,1213884,0,254916,1468800,606942,0.0,127458.0,734400
736000,637230,0,98770,736000,318615,0.0,49385.0,368000,849640,0,131693,981333,424820,0.0,65846.5,490666
1135000,938017,0,196983,1135000,469008,0.0,98491.5,567500,1250689,0,262644,1513333,625344,0.0,131322.0,756666
808000,699567,0,108433,808000,349783,0.0,54216.5,404000,932756,0,144577,1077333,466378,0.0,72288.5,538666
1039998,859503,0,180495,1039998,429751,0.0,90247.5,519999,1146004,0,240660,1386664,573002,0.0,120330.0,693332
2214372,1830060,0,384312,2214372,915030,0.0,192156.0,1107186,2440079,0,512417,2952496,1220039,0.0,256208.5,1476248
4073000,3366116,0,706884,4073000,1683058,0.0,353442.0,2036500,4488155,0,942512,5430667,2244077,0.0,471256.0,2715334
909999,787878,0,122121,909999,393939,0.0,61060.5,455000,1050504,0,162828,1213332,525252,0.0,81414.0,606666
819000,676860,0,142140,819000,338430,0.0,71070.0,409500,752066,0,157934,910000,376033,0.0,78967.0,455000
1160000,958678,0,201322,1160000,479339,0.0,100661.0,580000,1278237,0,268430,1546667,639118,0.0,134215.0,773334
900000,743801,0,156199,900000,371900,0.0,78099.5,450000,991735,0,208265,1200000,495867,0.0,104132.5,600000
1600000,1322314,0,277686,1600000,661157,0.0,138843.0,800000,1763085,0,370248,2133333,881542,0.0,185124.0,1066666
759998,628097,0,131901,759998,314048,0.0,65950.5,379999,837463,0,175868,1013331,418731,0.0,87934.0,506666
1069998,884296,0,185702,1069998,442148,0.0,92851.0,534999,1179061,0,247603,1426664,589530,0.0,123801.5,713332
885000,731405,0,153595,885000,365702,0.0,76797.5,442500,975207,0,204793,1180000,487603,0.0,102396.5,590000
1115000,921487,0,193513,1115000,460743,0.0,96756.5,557500,1228649,0,258018,1486667,614324,0.0,129009.0,743334
2965880,2451141,0,514739,2965880,1225570,0.0,257369.5,1482940,3268188,0,686319,3954507,1634094,0.0,343159.5,1977254
1649000,1362810,0,286190,1649000,681405,0.0,143095.0,824500,1817080,0,381587,2198667,908540,0.0,190793.5,1099334
1100000,909091,0,190909,1100000,454545,0.0,95454.5,550000,1212121,0,254546,1466667,606060,0.0,127273.0,733334
965000,797521,0,167479,965000,398760,0.0,83739.5,482500,1063361,0,223306,1286667,531680,0.0,111653.0,643334
3893999,3218181,0,675818,3893999,1609090,0.0,337909.0,1947000,4290908,0,901091,5191999,2145454,0.0,450545.5,2596000
1200000,991736,0,208264,1200000,495868,0.0,104132.0,600000,1322315,0,277685,1600000,661157,0.0,138842.5,800000
2245000,1855371,0,389629,2245000,927685,0.0,194814.5,1122500,2473828,0,519505,2993333,1236914,0.0,259752.5,1496666
1656493,1369003,0,287490,1656493,684501,0.0,143745.0,828246,1825337,0,383320,2208657,912668,0.0,191660.0,1104328
680000,561984,0,118016,680000,280992,0.0,59008.0,340000,749312,0,157355,906667,374656,0.0,78677.5,453334
659998,545453,0,114545,659998,272726,0.0,57272.5,329999,727271,0,152726,879997,363635,0.0,76363.0,439998
